10,12,,,,,,,,,,
-13,-13,-13,-13,-13,-13,-13,-13,-13,-13,-13,-13
-12,-12,-12,-12,-12,-12,-12,-12,-12,-12,-12,-12
11,11,11,11,11,11,11,11,11,11,11,11
11,10,10,10,10,10,10,10,10,10,10,10
11,10,10,10,10,-10,-10,10,10,10,10,10
11,10,10,10,10,-10,-10,10,10,10,10,10
11,10,10,10,10,10,10,10,10,10,10,10
11,10,10,10,10,10,10,10,10,10,10,10
-10,10,10,10,10,10,10,10,10,10,10,-10
-14,-14,-14,14,-14,-14,-14,-14,-14,-14,-14,-14
