10,11,,,,,,,,,
-15,-15,-15,-15,-15,-15,-15,-15,-15,-15,-15
-15,-15,-15,-15,-15,-15,-15,-15,-15,-15,-15
-15,-15,-15,-15,-15,-15,-15,-15,-15,-15,-15
-15,-15,15,15,15,15,15,15,15,-15,-15
-15,-15,15,15,15,15,15,15,15,-15,-15
-15,-15,15,15,15,15,15,15,15,-15,-15
-15,-15,15,15,15,15,15,15,15,-15,-15
-15,-15,15,15,15,15,15,15,15,-15,-15
-15,-15,15,15,15,15,15,15,15,-15,-15
-14,-14,-14,-14,-14,14,-14,-14,-14,-14,-14
