13,9,,,,,,,
-46,-46,-46,-46,46,-46,-46,-46,-46
46,46,-46,46,46,46,-46,46,46
46,45,-46,46,45,45,-46,46,45
46,45,-46,46,45,45,-46,46,45
46,45,-46,46,45,45,-46,46,45
46,45,-46,46,45,45,-46,46,45
46,45,-46,46,45,45,-46,46,45
46,45,-46,46,45,45,-46,46,45
46,45,-46,46,45,45,-46,46,45
46,45,-46,46,45,45,-46,46,45
46,45,-46,46,45,45,-46,46,45
46,45,-46,46,45,45,-46,46,45
-14,-14,-14,-14,14,-14,14,-14,-14
