14,9,,,,,,,
-16,-16,-16,-16,16,-16,-16,-16,-16
16,15,15,15,15,15,15,15,15
16,15,15,15,15,15,15,15,15
16,15,15,15,15,15,15,15,15
16,15,15,15,15,15,15,15,15
16,15,15,15,15,15,15,15,15
16,15,15,15,15,15,15,15,15
16,15,15,15,15,15,15,15,15
16,15,15,15,15,15,15,15,15
16,15,15,15,15,15,15,15,15
16,15,15,15,15,15,15,15,15
16,15,15,15,15,15,15,15,15
16,15,15,15,15,15,15,15,15
-14,-14,-14,-14,14,-14,14,-14,-14
