9,12,,,,,,,,,,
-10,-10,-10,-10,-10,-10,-10,-10,-10,-10,-10,-10
-10,-10,-10,-10,-10,-10,-10,-10,-10,-10,-10,-10
-10,-10,-10,-10,-10,10,10,10,10,10,-10,-10
-10,-10,-10,-10,-10,10,10,10,10,10,10,10
-10,10,10,10,10,10,10,10,-10,-10,10,10
-10,10,10,10,10,10,10,10,-10,-10,10,10
-10,10,10,10,10,10,10,10,10,10,10,10
-10,10,10,10,10,10,10,10,10,10,10,10
-14,-14,-14,14,-14,-14,-14,-14,-14,-14,-14,-14
