10,12,,,,,,,,,,
-13,-13,-13,-13,-13,-13,-13,-13,-13,-13,-13,-13
-12,-12,-12,-12,-12,-12,-12,-12,-12,-12,-12,-12
11,11,11,11,11,11,11,11,11,11,11,11
11,10,10,10,10,10,10,10,10,10,10,10
11,10,10,10,10,10,10,10,10,10,10,10
11,10,10,10,10,10,10,10,10,10,10,10
11,10,10,10,10,10,10,10,10,10,10,10
11,10,10,10,10,10,10,10,10,10,10,10
11,10,10,10,10,10,10,10,10,10,10,10
-14,-14,-14,14,-14,-14,-14,-14,-14,-14,-14,-14
doormat,2,9
pottedTree,0,8
pottedTree,11,8