6,,,,,,,,,,
-47,-47,-47,-47,-47,-47,-47,-47,-47,-47,-47
-47,-47,-47,-47,-47,-47,-47,-47,-47,-47,-47
-60,-60,53,53,53,53,53,53,53,53,-60
-61,53,53,53,53,53,53,53,53,-18,-60
53,53,53,53,53,53,53,53,53,19,53
53,17,53,53,53,53,53,53,53,53,53
