90,,,,,,,,,,,,,,,,,,,,,,,,,,,,,,,,,,,,,,,,,,,,,,,,,,,,,,,,,,,,,,,,,,,,,,,,,,,,,
0,0,0,0,0,0,0,0,0,0,0,0,0,0,0,0,0,0,0,0,0,0,0,0,0,0,0,0,0,0,0,0,0,0,0,0,0,0,0,0,0,0,0,0,0,0,0,0,0,0,0,0,0,0,0,0,0,0,0,0,0,0,0,0,0,0,0,0,0,0,0,0,0,0,0,0,0,0
0,0,0,0,0,0,0,0,0,0,0,0,0,0,0,0,0,0,0,0,0,0,0,0,0,0,0,0,0,0,0,0,0,0,0,0,0,0,0,0,0,0,0,0,0,0,0,0,0,0,0,0,0,0,0,0,0,0,0,0,0,0,0,0,0,0,0,0,0,0,0,0,0,0,0,0,0,0
0,0,0,0,0,0,0,0,0,0,0,0,0,0,0,0,0,0,0,0,0,0,0,0,0,0,0,0,0,0,0,0,0,0,0,0,0,0,0,0,53,54,54,54,54,54,54,54,55,0,0,0,0,0,0,0,0,0,0,0,0,0,0,0,0,0,0,0,0,0,0,0,0,0,0,0,0,0
0,0,0,0,0,0,0,0,0,0,0,0,0,0,0,0,0,0,0,0,0,0,0,0,0,0,0,0,0,0,0,0,0,0,0,0,0,0,0,0,56,57,57,57,57,57,57,57,63,54,54,54,54,54,54,54,55,0,0,0,0,0,0,0,0,0,0,0,0,0,0,0,0,0,0,0,0,0
0,0,0,0,0,0,0,0,0,0,0,0,0,0,0,0,0,0,0,0,0,0,0,0,0,0,0,0,0,0,0,0,0,0,0,0,0,0,0,0,56,57,57,57,57,57,57,57,57,57,57,57,-40,-41,-41,-42,58,0,0,0,0,0,0,0,0,0,0,0,0,0,0,0,0,0,0,0,0,0
0,0,0,0,0,0,0,0,0,0,0,0,0,0,0,0,0,0,0,0,0,0,0,0,0,0,0,0,0,0,0,0,0,0,0,0,0,0,0,0,56,57,57,57,57,57,57,57,57,57,57,57,-43,-44,-44,-45,58,0,0,0,0,0,0,0,0,0,0,0,0,0,0,0,0,0,0,0,0,0
0,0,0,0,0,0,0,0,0,0,0,0,0,0,0,0,0,0,0,0,0,0,0,0,0,0,0,0,0,0,0,0,0,0,0,0,0,0,0,53,62,57,57,57,57,57,57,57,57,57,57,57,-46,9,-48,-48,58,0,0,0,0,0,0,0,0,0,0,0,0,0,0,0,0,0,0,0,0,0
0,0,0,0,0,0,0,0,0,0,0,0,0,0,0,0,0,0,0,0,0,0,0,0,0,0,0,0,0,0,0,0,0,0,0,0,0,0,0,56,57,57,57,57,57,57,57,57,57,57,57,57,57,57,57,57,58,0,0,0,0,0,0,0,0,0,0,0,0,0,0,0,0,0,0,0,0,0
0,0,0,0,0,0,0,0,0,0,0,0,0,0,0,0,0,0,0,0,0,0,0,0,0,0,0,0,0,0,0,0,0,0,0,0,0,0,0,56,57,57,57,57,57,57,57,57,57,57,65,60,60,60,60,60,61,0,0,0,0,0,0,0,0,0,0,0,0,0,0,0,0,0,0,0,0,0
0,0,0,0,0,0,0,0,0,0,0,0,0,0,0,0,0,0,0,0,0,0,0,0,0,0,0,0,0,0,0,0,0,0,0,0,0,0,0,56,57,57,57,57,57,57,57,57,57,57,58,0,0,0,0,0,0,0,0,0,0,0,0,0,0,0,0,0,0,0,0,0,0,0,0,0,0,0
0,0,0,0,0,0,0,0,0,0,0,0,0,0,0,0,0,0,0,0,0,0,0,0,0,0,0,0,0,0,0,0,0,0,0,0,0,0,0,56,57,57,57,57,57,57,57,57,57,57,58,0,0,0,0,0,0,0,0,0,0,0,0,0,0,0,0,0,0,0,0,0,0,0,0,0,0,0
0,0,0,0,0,0,0,0,0,0,0,0,0,0,0,0,0,0,0,0,0,0,0,0,0,0,0,0,0,0,0,0,0,0,0,0,0,0,0,60,60,60,60,60,60,60,60,60,60,60,61,0,0,0,0,0,0,0,0,0,0,0,0,0,0,0,0,0,0,0,0,0,0,0,0,0,0,0
0,0,0,0,0,0,0,0,0,0,0,0,0,0,0,0,0,0,0,0,0,0,0,0,0,0,0,0,0,0,0,0,0,0,0,0,0,0,0,0,0,0,0,0,0,0,0,0,0,0,0,0,0,0,0,0,0,0,0,0,0,0,0,0,0,0,0,0,0,0,0,0,0,0,0,0,0,0
0,0,0,0,0,53,54,54,54,55,0,0,0,0,0,0,0,0,0,0,0,0,0,0,0,0,0,0,0,0,0,0,0,0,0,0,0,0,0,0,0,0,0,0,0,0,0,0,0,0,0,0,0,0,0,0,0,0,0,0,0,0,0,0,0,0,0,0,0,0,0,0,0,0,0,0,0,0
0,0,0,0,0,56,57,57,57,58,0,0,0,0,0,0,0,0,0,0,0,0,0,0,0,0,0,0,0,0,0,0,0,0,0,0,0,0,0,0,0,0,0,0,0,0,0,0,0,0,0,0,0,0,0,0,0,0,0,0,0,0,0,0,0,0,0,0,0,0,0,0,0,0,0,0,0,0
0,0,0,0,0,56,57,57,57,58,0,0,0,0,0,0,0,0,0,0,0,0,0,0,0,0,0,0,0,0,0,0,0,0,0,0,0,0,0,0,0,0,0,0,0,0,0,0,0,0,0,0,0,0,0,0,0,0,0,0,0,0,0,0,0,0,0,0,0,0,0,0,0,0,0,0,0,0
0,0,0,0,0,56,57,57,57,58,0,0,0,0,0,0,0,0,0,0,0,0,0,0,0,0,0,0,0,0,0,0,0,0,0,0,0,0,0,0,0,0,0,0,0,0,0,0,0,0,0,0,0,0,0,0,0,0,0,0,0,0,0,0,0,0,0,0,0,0,0,0,0,0,0,0,0,0
0,0,0,0,0,59,60,60,60,61,0,0,0,0,0,0,0,0,0,0,0,0,0,0,0,0,0,0,0,0,0,0,0,0,0,0,0,0,0,0,0,0,0,0,0,0,0,0,0,0,0,0,0,0,0,0,0,0,0,0,0,0,0,0,0,0,0,0,0,0,0,0,0,0,0,0,0,0
0,0,0,0,0,0,0,0,0,0,0,0,0,0,0,0,0,0,0,0,0,0,0,0,0,0,0,0,0,0,0,0,0,0,0,0,0,0,0,0,0,0,0,0,0,0,0,0,0,0,0,0,0,0,0,0,0,0,0,0,0,0,0,0,0,0,0,0,0,0,0,0,0,0,0,0,0,0
0,0,0,0,0,0,0,0,0,0,0,0,0,0,0,0,0,0,0,0,0,0,0,0,0,0,0,0,0,0,0,0,0,0,0,0,0,0,0,0,0,0,0,0,0,0,0,0,0,0,0,0,0,0,0,0,0,0,0,0,0,0,0,0,0,0,0,0,0,0,0,0,0,0,0,0,0,0
0,0,0,0,0,0,0,0,0,0,0,0,0,0,0,0,0,0,0,0,0,0,0,0,0,0,0,0,0,0,0,0,0,0,0,0,0,0,0,0,0,0,0,0,0,0,0,0,0,0,0,0,0,0,0,0,0,0,0,0,0,0,0,0,0,0,0,0,0,0,0,0,0,0,0,0,0,0
0,0,0,0,0,0,0,0,0,0,0,0,0,0,0,0,0,0,0,0,0,0,0,0,0,0,0,0,0,0,0,0,0,0,0,0,0,0,0,0,0,0,0,0,0,0,0,0,0,0,0,0,0,0,0,0,0,0,0,0,0,0,0,0,0,0,0,0,0,0,0,0,0,0,0,0,0,0
0,0,0,0,0,0,0,0,0,0,0,0,0,0,0,0,0,0,0,0,0,0,0,0,0,0,0,0,0,0,0,0,0,0,0,0,0,0,0,0,0,0,0,0,0,0,0,0,0,0,0,0,0,0,0,0,0,0,0,0,0,0,0,0,0,0,0,0,0,0,0,0,0,0,0,0,0,0
0,0,0,0,0,0,0,0,0,0,0,0,0,0,0,0,0,0,0,0,0,0,0,0,0,0,0,0,0,0,0,0,0,0,0,0,0,0,0,0,0,0,0,0,0,0,0,0,0,0,0,0,0,0,0,0,0,0,0,0,0,0,0,0,0,0,0,0,0,0,0,0,0,0,0,0,0,0
0,0,0,0,0,0,0,0,0,0,0,0,0,0,0,0,0,0,0,0,0,0,0,0,0,0,0,0,0,0,0,0,0,0,0,0,0,0,0,0,0,0,0,0,0,0,0,0,0,0,0,0,0,0,0,0,0,0,0,0,0,0,0,0,0,0,0,0,0,0,0,0,0,0,0,0,0,0
0,0,0,0,0,0,0,0,0,0,0,0,0,0,0,0,0,0,0,0,0,0,0,0,0,0,0,0,0,0,0,0,0,0,0,0,0,0,0,0,0,0,0,0,0,0,0,0,0,0,0,0,0,0,0,0,0,0,0,0,0,0,0,0,0,0,0,0,0,0,0,0,0,0,0,0,0,0
0,0,0,0,0,0,0,0,0,0,0,0,0,0,0,0,0,0,0,0,0,0,0,0,0,0,0,0,0,0,0,0,0,0,0,0,0,0,0,0,0,0,0,0,0,0,0,0,0,0,0,0,0,0,0,0,0,0,0,0,0,0,0,0,0,0,0,0,0,0,0,0,0,0,0,0,0,0
0,0,0,0,0,0,0,0,0,0,0,0,0,0,0,0,0,0,0,0,0,0,0,0,0,0,0,0,0,0,0,0,0,0,0,0,0,0,0,0,0,0,0,0,0,0,0,0,0,0,0,0,0,0,0,0,0,0,0,0,0,0,0,0,0,0,0,0,0,0,0,0,0,0,0,0,0,0
0,0,0,0,0,0,0,0,0,0,0,0,0,0,0,0,0,0,0,0,0,0,0,0,0,0,0,0,0,0,0,0,0,0,0,0,0,0,0,0,0,0,0,0,0,0,0,0,0,0,0,0,0,0,0,0,0,0,0,0,0,0,0,0,0,0,0,0,0,0,0,0,0,0,0,0,0,0
0,0,0,0,0,0,0,0,0,0,0,0,0,0,0,0,0,0,0,0,0,0,0,0,0,0,0,0,0,0,0,0,0,0,0,0,0,0,0,0,0,0,0,0,0,0,0,0,0,0,0,0,0,0,0,0,0,0,0,0,0,0,0,0,0,0,0,0,0,0,0,0,0,0,0,0,0,0
0,0,0,0,0,0,0,0,0,0,0,0,0,0,0,0,0,0,0,0,0,0,0,0,0,0,0,0,0,0,0,0,0,0,0,0,0,0,0,0,0,0,0,0,0,0,0,0,0,0,0,0,0,0,0,0,0,0,0,0,0,0,0,0,0,0,0,0,0,0,0,0,0,0,0,0,0,0
0,0,0,0,0,0,0,0,0,0,0,0,0,0,0,0,0,0,0,0,0,0,0,0,0,0,0,0,0,0,0,0,0,0,0,0,0,0,0,0,0,0,0,0,0,0,0,0,0,0,0,0,0,0,0,0,0,0,0,0,0,0,0,0,0,0,0,0,0,0,0,0,0,0,0,0,0,0
0,0,0,0,0,0,0,0,0,0,0,0,0,0,0,0,0,0,0,0,0,0,53,54,54,54,54,54,54,54,54,54,54,54,54,54,54,54,54,54,54,54,54,54,54,54,54,54,54,54,54,54,54,54,54,54,54,54,54,54,54,54,54,55,0,0,0,0,0,0,0,0,0,0,0,0,0,0
0,0,0,0,0,0,0,0,0,0,0,0,0,0,0,0,0,0,0,0,53,54,62,57,57,57,57,57,57,57,57,57,57,57,57,57,57,57,57,57,57,57,57,57,57,57,57,57,57,57,57,57,57,57,57,57,57,57,57,57,57,57,57,63,54,54,55,0,0,0,0,0,0,0,0,0,0,0
0,0,0,0,0,0,0,0,0,0,0,0,0,0,0,0,0,0,53,54,62,57,57,57,57,57,57,57,57,57,57,57,57,57,57,57,57,57,57,57,57,57,57,57,57,57,57,57,57,57,57,57,57,57,57,-41,-41,-41,-41,-41,-41,-41,57,57,57,57,63,54,55,0,0,0,0,0,0,0,0,0
0,0,0,0,0,0,0,0,0,0,0,0,0,0,0,-41,-41,-41,-41,-41,-41,-41,-41,-41,-41,-41,-41,-41,-41,-41,-41,-41,-41,-41,33,34,-41,-41,-41,-41,-41,-41,-41,-41,-41,-41,-41,-41,-41,-41,-41,-41,-41,33,34,-41,4,4,4,4,4,-41,-41,-41,-41,-41,-41,-41,-41,-41,-41,-41,-41,-41,-41,0,0,0
0,0,0,0,0,0,0,0,0,0,0,0,0,0,-41,-41,4,4,4,4,4,4,4,4,4,4,4,4,4,4,4,4,4,4,4,4,4,4,4,4,4,4,2,4,4,4,4,4,4,4,4,4,4,4,4,4,4,4,4,4,4,4,4,4,4,4,4,4,4,4,4,4,4,4,-41,-41,-41,0
0,0,0,0,0,0,0,0,0,0,0,0,0,0,-41,4,75,76,76,76,76,76,76,76,76,76,76,76,76,76,76,76,76,76,76,76,76,76,76,76,76,76,76,76,76,76,76,76,76,76,76,76,76,76,76,76,76,76,76,76,76,76,76,76,76,76,76,76,76,76,76,76,77,4,4,4,-41,-41
0,0,0,0,0,0,0,0,0,0,0,0,0,0,-41,4,78,79,79,79,79,79,79,79,79,79,79,79,79,79,79,79,79,79,79,79,79,79,79,79,79,79,79,79,79,79,79,79,79,79,79,79,79,79,79,79,79,79,79,79,79,79,79,79,79,79,79,79,79,79,79,79,80,4,4,4,4,4
0,0,0,0,0,0,0,0,0,0,0,0,0,0,-41,4,78,79,87,82,82,82,82,82,82,82,82,82,82,82,82,82,82,82,82,82,82,82,82,82,82,82,82,82,82,82,82,82,82,82,82,82,82,82,82,82,82,82,82,82,82,82,82,82,82,82,82,82,82,82,86,79,80,4,4,4,4,4
0,0,0,0,0,0,0,0,0,0,0,0,0,0,-41,4,78,79,80,4,4,4,4,4,4,4,4,4,4,4,4,4,4,4,4,4,4,4,4,4,4,4,4,4,4,4,4,4,4,4,4,4,4,4,4,4,4,4,4,4,4,4,4,4,4,4,4,4,4,4,78,79,80,4,4,4,4,4
0,0,0,0,0,0,0,0,0,0,0,0,0,0,-41,4,78,79,80,4,4,4,4,4,4,4,4,4,4,4,4,4,4,4,4,4,4,4,4,4,4,4,4,4,4,4,4,4,4,4,4,4,4,4,4,4,4,4,4,4,4,4,4,4,4,4,4,4,4,4,78,79,80,4,4,4,4,4
0,0,0,0,0,0,0,0,0,0,0,0,0,0,-41,4,78,79,80,4,4,4,4,4,4,4,4,4,4,4,4,4,4,4,4,4,4,4,4,4,4,4,4,4,4,4,4,4,4,4,4,4,4,4,4,4,4,4,4,4,4,4,4,4,4,4,4,4,4,4,78,79,80,4,4,4,4,4
0,0,0,0,0,0,0,0,0,0,0,0,0,-41,-41,4,78,79,80,4,4,4,4,4,4,4,4,4,4,4,4,4,4,4,4,4,4,4,4,4,4,4,4,4,4,4,4,4,4,4,4,4,4,4,4,4,4,4,4,4,4,4,0,0,0,0,0,0,4,4,78,79,80,4,4,4,4,4
0,0,0,0,0,0,0,0,0,0,0,0,0,-41,4,4,78,79,80,4,4,4,4,4,4,4,4,4,4,4,4,4,4,4,4,4,4,4,4,4,4,4,4,4,4,4,4,4,4,4,4,4,4,4,4,4,4,4,4,4,4,4,0,0,0,0,0,0,4,4,78,79,80,4,4,4,4,4
0,0,0,0,0,0,0,0,0,0,0,0,0,-41,4,4,78,79,80,4,4,4,4,4,4,4,4,4,4,4,4,4,4,4,4,4,4,4,4,4,4,4,4,4,4,4,4,4,4,4,4,4,4,4,4,4,4,4,4,4,4,4,0,0,0,0,0,0,4,4,78,79,80,4,4,4,4,4
0,0,0,0,0,0,0,0,0,0,0,0,0,-41,4,4,78,79,80,4,4,4,4,4,4,4,4,4,4,4,4,4,4,4,4,4,4,4,4,4,4,4,4,4,4,4,4,4,4,4,4,4,4,4,4,4,4,4,4,4,4,4,0,0,0,0,0,0,4,4,78,79,80,4,4,4,4,4
0,0,0,0,0,0,0,0,0,0,0,0,0,-41,4,4,78,79,80,4,4,4,4,4,4,4,4,4,75,76,76,76,76,76,76,76,76,76,76,76,76,76,76,76,76,76,76,76,76,76,76,76,76,76,76,76,76,76,76,76,77,4,0,0,0,0,0,0,4,4,78,79,80,4,4,4,4,4
0,0,0,0,0,0,0,0,0,0,0,0,0,-41,4,4,78,79,80,4,4,4,4,4,4,4,4,4,78,79,79,79,79,79,79,79,79,79,79,79,79,79,79,79,79,79,79,79,79,79,79,79,79,79,79,79,79,79,79,79,80,4,0,0,0,0,0,0,4,4,78,79,80,4,4,4,4,4
0,0,0,0,0,0,0,0,0,0,0,0,0,-41,4,4,78,79,80,4,4,4,4,4,4,4,4,4,78,79,87,82,82,82,82,82,82,82,82,82,82,82,82,82,82,82,82,82,82,82,82,82,82,82,82,82,82,82,86,79,80,4,0,0,0,0,0,0,4,4,78,79,80,4,4,4,4,4
0,0,0,0,0,0,0,0,0,0,0,0,0,-41,4,4,78,79,80,4,4,4,4,4,4,4,4,4,78,79,80,4,4,4,4,4,4,4,4,4,4,4,4,4,4,4,4,4,4,4,4,4,4,4,4,4,4,4,78,79,80,4,0,0,0,0,0,0,4,4,78,79,80,4,4,4,4,4
0,0,0,0,0,0,0,0,0,0,0,0,0,-41,-41,4,78,79,80,4,4,4,4,4,4,4,4,4,78,79,80,4,4,4,4,4,4,4,4,4,4,4,4,4,4,4,4,4,4,4,4,4,4,4,4,4,4,4,78,79,80,4,0,0,0,0,0,0,4,4,78,79,80,4,4,4,4,4
0,0,0,0,0,0,0,0,0,0,0,0,0,0,-41,4,78,79,80,4,4,4,4,4,4,4,4,4,78,79,80,4,4,4,4,4,4,4,4,4,4,4,4,4,4,4,4,4,4,4,4,4,4,4,4,4,4,4,78,79,80,4,0,0,0,0,0,0,4,4,78,79,80,4,4,4,4,4
0,0,0,0,0,0,0,0,0,0,0,0,0,0,-41,4,78,79,80,4,4,4,4,4,4,4,4,4,78,79,80,4,4,4,4,4,4,4,4,4,4,4,4,4,4,4,4,4,4,4,4,4,4,4,4,4,4,4,78,79,80,4,0,0,0,0,0,0,4,4,78,79,80,4,4,4,4,4
0,0,0,0,0,0,0,0,0,0,0,0,0,0,-41,4,78,79,80,4,4,4,4,4,4,4,4,4,78,79,80,4,4,4,4,4,4,4,4,4,4,4,4,4,4,4,4,4,4,4,4,4,4,4,4,4,4,4,78,79,80,4,0,0,0,0,0,0,4,4,78,79,80,4,4,4,4,4
-41,-41,-41,0,0,0,0,0,0,0,0,0,0,0,-41,4,78,79,80,4,4,4,4,4,4,4,4,4,78,79,80,4,4,4,4,4,4,4,4,4,4,4,4,4,4,4,4,4,4,4,4,4,4,4,4,4,4,4,78,79,80,4,0,0,0,0,0,0,4,4,78,79,80,4,4,4,4,4
4,5,-41,-41,0,0,0,0,0,0,0,0,0,-41,-41,4,78,79,80,4,4,4,4,4,4,4,4,4,78,79,80,4,4,4,4,4,4,4,4,4,4,4,4,4,4,4,4,4,4,4,4,4,4,4,4,4,4,4,78,79,80,4,4,4,4,4,4,4,4,4,78,79,80,4,4,4,4,4
5,4,5,-41,-41,-41,-41,-41,-41,-41,-41,-41,-41,-41,4,4,78,79,80,4,4,4,4,4,4,4,4,4,78,79,80,4,4,4,4,4,4,4,4,4,4,4,4,4,4,4,4,4,4,4,4,4,4,4,4,4,4,4,78,79,80,4,4,4,4,4,4,4,4,4,78,79,80,4,4,4,4,4
-42,5,5,4,5,5,5,5,4,5,4,5,5,5,4,4,78,79,80,4,4,4,4,4,4,4,4,4,78,79,80,4,4,4,4,4,4,4,4,4,4,4,4,4,4,4,4,4,4,4,4,4,4,4,4,4,4,4,78,79,80,4,4,4,4,4,4,4,4,4,78,79,80,4,4,4,4,4
-45,5,4,5,5,5,5,5,5,4,5,5,4,5,4,4,78,79,80,4,4,4,4,4,4,4,4,4,78,79,80,4,4,4,4,4,4,4,4,4,4,4,4,4,4,4,4,4,4,4,4,4,4,4,4,4,4,4,78,79,80,4,4,4,4,4,4,4,4,4,78,79,80,4,4,4,4,4
-45,5,5,5,5,4,5,5,5,5,5,5,5,4,5,4,78,79,80,4,4,4,4,4,4,4,4,4,78,79,80,4,4,4,4,4,4,4,75,76,76,76,76,76,76,76,76,76,76,76,77,4,4,4,4,4,4,4,78,79,80,4,4,4,4,4,4,4,4,4,78,79,80,4,4,4,4,4
-45,5,5,5,5,5,5,4,5,4,5,5,5,5,4,4,78,79,80,4,4,4,4,4,4,4,4,4,78,79,80,4,4,4,4,4,4,4,78,79,79,79,79,79,79,79,79,79,79,79,80,4,4,4,4,4,4,4,78,79,80,4,4,4,4,4,4,4,4,4,78,79,80,4,4,4,4,4
-45,20,21,21,21,21,21,21,21,21,21,22,75,76,76,76,84,79,85,76,76,76,76,76,76,76,76,76,84,79,80,4,4,4,4,4,4,4,78,79,-66,-67,-68,79,79,79,-66,-67,-68,79,80,4,4,4,4,4,4,4,78,79,85,76,76,76,76,76,76,76,76,76,84,79,85,76,76,76,76,76
9,23,24,24,24,24,24,24,24,24,24,25,78,79,79,79,79,79,79,79,79,79,79,79,79,79,79,79,79,79,80,4,4,4,4,4,4,4,78,79,-69,-70,-71,79,79,79,-69,-70,-71,79,80,4,4,4,4,4,4,4,78,79,79,79,79,79,79,79,79,79,79,79,79,79,79,79,79,79,79,79
-45,26,27,27,27,27,27,27,27,27,27,28,81,82,82,82,86,79,87,82,82,82,82,82,82,82,82,82,86,79,80,4,4,4,4,4,4,4,78,79,-72,-73,-74,79,79,79,-72,-73,-74,79,80,4,4,4,4,4,4,4,78,79,87,82,82,82,82,82,82,82,82,82,86,79,87,82,82,82,82,82
-45,5,5,5,5,5,5,5,5,5,5,5,5,5,5,4,78,79,80,4,4,4,4,4,4,4,4,4,78,79,80,4,4,4,4,4,4,4,78,79,79,79,79,79,79,79,79,79,79,79,80,4,4,4,4,4,4,4,78,79,80,4,4,4,4,4,4,4,4,4,78,79,80,4,4,4,4,4
-45,5,5,5,5,5,4,5,5,5,5,5,5,5,5,4,78,79,80,4,4,4,4,4,4,4,4,4,78,79,80,4,4,4,4,4,4,4,81,82,82,82,82,82,82,82,82,82,82,82,83,4,4,4,4,4,4,4,78,79,80,4,4,4,4,4,4,4,4,4,78,79,80,4,4,4,4,4
-48,5,5,5,5,5,5,5,5,5,5,5,5,5,5,4,78,79,80,4,0,0,0,0,0,0,0,4,78,79,80,4,4,4,4,4,4,4,4,4,4,4,4,4,4,4,4,4,4,4,4,4,4,4,4,4,4,4,78,79,80,4,4,4,4,4,4,4,4,4,78,79,80,4,4,4,4,4
5,5,5,5,5,5,5,5,5,5,5,5,5,5,5,4,78,79,80,4,0,0,0,0,0,0,0,4,78,79,80,4,4,4,4,4,4,4,4,4,4,4,4,4,4,4,4,4,4,4,4,4,4,4,4,4,4,4,78,79,80,4,4,4,4,4,4,4,4,4,78,79,80,4,4,4,4,4
5,5,5,4,5,5,5,5,5,5,5,5,5,5,5,4,78,79,80,4,0,0,0,0,0,0,0,4,78,79,80,4,4,4,4,4,4,4,4,4,4,4,4,4,4,4,4,4,4,4,4,4,4,4,4,4,4,4,78,79,80,4,4,4,4,4,4,4,4,4,78,79,80,4,4,4,4,4
5,5,5,5,5,5,5,5,5,5,5,5,5,5,5,4,78,79,80,4,0,0,0,0,0,0,0,4,78,79,80,4,4,4,4,4,4,4,4,4,4,4,4,4,4,4,4,4,4,4,4,4,4,4,4,4,4,4,78,79,80,4,4,4,4,4,4,4,4,4,78,79,80,4,4,4,4,4
5,5,5,5,5,5,5,5,5,5,4,5,5,5,5,4,78,79,80,4,0,0,0,0,0,0,0,4,78,79,80,4,4,4,4,4,4,4,4,4,4,4,4,4,4,4,4,4,4,4,4,4,4,4,4,4,4,4,78,79,80,4,4,20,29,24,30,22,4,4,78,79,80,4,4,4,4,4
4,5,4,5,4,4,5,4,4,5,5,4,5,5,4,4,78,79,80,4,0,0,0,0,0,0,0,4,78,79,80,4,4,4,4,4,4,4,4,4,4,4,4,4,4,4,4,4,4,4,4,4,4,4,4,4,4,4,78,79,80,4,4,23,24,24,24,25,4,4,78,79,80,4,4,4,4,4
-4,-4,4,4,-4,-4,-4,-4,-4,-4,-4,-4,-4,-4,-4,-4,78,79,80,4,0,0,0,0,0,0,0,4,78,79,80,4,4,4,4,4,4,4,4,4,4,4,4,4,4,4,4,4,4,4,4,4,4,4,4,4,4,4,78,79,80,4,4,26,27,27,27,28,4,4,78,79,80,4,4,4,4,4
-4,-4,5,4,-4,-4,-4,-4,-4,-4,-4,-4,-4,-4,-4,-4,78,79,80,4,0,0,0,0,0,0,0,4,78,79,80,4,4,4,4,4,4,4,4,4,4,4,4,4,4,4,4,4,4,4,4,4,4,4,4,4,4,4,78,79,80,4,4,4,4,4,4,4,4,4,78,79,80,4,4,4,4,4
-4,-4,4,5,-4,-4,-4,-4,-4,-4,-4,-4,-4,-4,-4,-4,78,79,80,4,0,0,0,0,0,0,0,4,78,79,80,4,4,4,4,4,4,4,4,4,4,4,4,4,4,4,4,4,4,4,4,4,4,4,4,4,4,4,78,79,80,4,4,4,4,4,4,4,4,4,78,79,80,4,4,4,4,4
-4,-4,4,4,-4,-4,-4,-4,-4,-4,-4,-4,-4,-4,-4,-4,78,79,80,4,0,0,0,0,0,0,0,4,78,79,80,4,4,4,4,4,4,4,4,4,4,4,4,4,4,4,4,4,4,4,4,4,4,4,4,4,4,4,78,79,80,4,4,4,4,4,4,4,4,4,78,79,80,4,4,4,4,4
4,4,4,4,-4,-4,-4,-4,-4,-4,-4,-4,-4,-4,-4,-4,78,79,80,4,0,0,0,0,0,0,0,4,78,79,85,76,76,76,76,76,76,76,76,76,76,76,76,76,76,76,76,76,76,76,76,76,76,76,76,76,76,76,84,79,80,4,4,4,4,4,4,4,4,4,78,79,80,4,4,4,4,4
4,4,4,4,-4,-4,-4,-4,-4,-4,-4,-4,-4,-4,-4,-4,78,79,80,4,0,0,0,0,0,0,0,4,78,79,79,79,79,79,79,79,79,79,79,79,79,79,79,79,79,79,79,79,79,79,79,79,79,79,79,79,79,79,79,79,80,4,4,4,4,4,4,4,4,4,78,79,80,4,4,4,4,4
4,4,4,4,-4,-4,-4,-4,-4,-4,-4,-4,-4,-4,-4,-4,78,79,80,4,0,0,0,0,0,0,0,4,81,82,82,82,82,82,82,82,82,82,82,82,82,82,82,86,79,87,82,82,82,82,82,82,82,82,82,82,82,82,82,82,83,4,4,4,4,4,4,4,4,4,78,79,80,4,4,4,4,4
4,4,4,4,-4,-4,-4,-4,-4,-4,-4,-4,-4,-4,-4,-4,78,79,80,4,0,0,0,0,0,0,0,4,4,4,4,4,4,4,4,4,4,4,4,4,4,4,4,78,79,80,4,4,4,4,4,4,4,4,4,4,4,4,4,4,4,4,4,4,4,4,4,4,4,4,78,79,80,4,4,4,4,4
4,4,4,4,-4,-4,-4,-4,-4,-4,-4,-4,-4,-4,-4,-4,78,79,80,4,4,4,4,4,4,4,4,4,4,4,4,4,4,4,4,4,4,4,4,4,4,4,4,78,79,80,4,4,4,4,4,4,4,4,4,4,4,4,4,4,4,4,4,4,4,4,4,4,4,4,78,79,80,4,4,4,4,4
4,4,4,4,-4,-4,-4,-4,-4,-4,-4,-4,-4,-4,-4,-4,78,79,80,4,4,4,4,4,4,4,4,4,4,4,4,4,4,4,4,4,4,4,4,4,4,4,4,78,79,80,4,4,4,4,4,4,4,4,4,4,4,4,4,4,4,4,4,4,4,4,4,4,4,4,78,79,80,4,4,4,4,4
4,4,4,4,-4,-4,-4,-4,-4,-4,-4,-4,-4,-4,-4,-4,78,79,80,4,4,4,4,4,4,4,4,4,4,4,4,4,4,4,4,4,4,4,4,4,4,4,4,78,79,80,4,4,4,4,4,4,4,4,4,4,4,4,4,4,4,4,4,4,4,4,4,4,4,4,78,79,80,4,4,4,4,4
4,4,4,4,-4,-4,-4,-4,-4,-4,-4,-4,-4,-4,-4,-4,78,79,80,4,4,4,4,4,4,4,4,4,4,4,4,4,4,4,4,4,4,4,4,4,4,4,4,78,79,80,4,4,4,4,4,4,4,4,4,4,4,4,4,4,4,4,4,4,4,4,4,4,4,4,78,79,80,4,4,4,4,4
-4,-4,-4,-4,-4,-4,-4,-4,-4,-4,-4,-4,-4,-4,-4,-4,78,79,80,4,4,4,4,4,4,4,4,4,4,4,4,4,4,4,4,4,4,4,4,4,4,4,4,78,79,80,4,4,4,4,4,4,4,4,4,4,4,4,4,4,4,4,4,4,4,4,4,4,4,4,78,79,80,4,4,4,4,4
-4,-4,-4,-4,-4,-4,-4,-4,-4,-4,-4,-4,-4,-4,-4,-4,78,79,80,4,4,4,4,4,4,4,4,4,4,4,4,4,4,4,4,4,4,4,4,4,4,4,4,78,79,80,4,4,4,4,4,4,4,4,4,4,4,4,4,4,4,4,4,4,4,4,4,4,4,4,78,79,80,4,4,4,4,4
-4,-4,-4,-4,-4,-4,-4,-4,-4,-4,-4,-4,-4,-4,-4,-4,78,79,85,76,76,76,76,76,76,76,76,76,76,76,76,76,76,76,76,76,76,76,76,76,76,76,76,84,79,85,76,76,76,76,76,76,76,76,76,76,76,76,76,76,76,76,76,76,76,76,76,76,76,76,84,79,80,4,4,4,4,4
-4,-4,-4,-4,-4,-4,-4,-4,-4,-4,-4,-4,-4,-4,-4,-4,78,79,79,79,79,79,79,79,79,79,79,79,79,79,79,79,79,79,79,79,79,79,79,79,79,79,79,79,79,79,79,79,79,79,79,79,79,79,79,79,79,79,79,79,79,79,79,79,79,79,79,79,79,79,79,79,80,4,4,4,4,4
-4,-4,-4,-4,-4,-4,-4,-4,-4,-4,-4,-4,-4,-4,-4,-4,81,82,82,82,82,82,82,82,82,82,82,82,82,82,82,82,82,82,82,82,82,82,82,82,82,82,82,86,79,87,82,82,82,82,82,82,82,82,82,82,82,82,82,82,82,82,82,82,82,82,82,82,82,82,82,82,83,4,4,4,4,4
-4,-4,-4,-4,-4,-4,-4,-4,-4,-4,-4,-4,-4,-4,-4,-4,4,4,4,4,4,4,4,4,4,4,4,4,4,4,4,4,4,4,4,4,4,4,4,4,4,4,4,78,79,80,4,4,4,4,4,4,4,4,4,4,4,4,4,4,4,4,4,4,4,4,4,4,4,4,4,4,4,4,4,4,4,4
-4,-4,-4,-4,-4,-4,-4,-4,-4,-4,-4,-4,-4,-4,-4,-4,-4,-4,-4,-4,-4,-4,-4,-4,-4,-4,-4,-4,-4,-4,-4,-4,-4,-4,-4,-4,-4,-4,-4,-4,,,,78,79,80,,,,,,,,,,,,,,,,,,,,,,,,,,,,,,,,
-4,-4,-4,-4,-4,-4,-4,-4,-4,-4,-4,-4,-4,-4,-4,-4,-4,-4,-4,-4,-4,-4,-4,-4,-4,-4,-4,-4,-4,-4,-4,-4,-4,-4,-4,-4,-4,-4,-4,-4,,,,78,79,80,,,,,,,,,,,,,,,,,,,,,,,,,,,,,,,,
-4,-4,-4,-4,-4,-4,-4,-4,-4,-4,-4,-4,-4,-4,-4,-4,-4,-4,-4,-4,-4,-4,-4,-4,-4,-4,-4,-4,-4,-4,-4,-4,-4,-4,-4,-4,-4,-4,-4,-4,,,,,,,,,,,,,,,,,,,,,,,,,,,,,,,,,,,,,,
-4,-4,-4,-4,-4,-4,-4,-4,-4,-4,-4,-4,-4,-4,-4,-4,-4,-4,-4,-4,-4,-4,-4,-4,-4,-4,-4,-4,-4,-4,-4,-4,-4,-4,-4,-4,-4,-4,-4,-4,,,,,,,,,,,,,,,,,,,,,,,,,,,,,,,,,,,,,,
