85,,,,,,,,,,,,,,,,,,,,,,,,,,,,,,,,,,,,,,,,,,,,,,,,,,,,,,,,,,,,,,,,,,,,,,,,,,,,,,,,,,,,,,,,,,,,,,,,,,,,,,,,,,,,,,,,,,,,,,,,,,,,,
0,0,0,0,0,0,0,0,0,0,0,0,0,0,0,0,0,0,0,0,0,0,0,0,0,0,0,0,0,0,0,0,0,0,0,0,0,0,0,0,0,0,0,0,0,0,0,0,0,0,0,0,0,0,0,0,0,0,0,0,0,0,0,0,0,0,0,0,0,0,0,0,0,0,0,0,0,0,0,0,0,0,0,0,0,0,0,0,0,0,0,0,0,0,0,0,0,0,0,0,0,0,0,0,0,0,0,0,0,0,0,0,0,0,0,0,0,0,0,0,0,0,0,0,0,0
0,0,0,0,0,0,0,0,0,0,0,0,0,0,0,0,0,0,0,0,0,0,0,0,0,0,0,0,0,0,0,0,0,0,0,0,0,0,0,0,0,0,0,0,0,0,0,0,0,0,0,0,0,0,0,0,0,0,0,0,0,0,0,0,0,0,0,0,0,0,0,0,0,0,0,0,0,0,0,0,0,0,0,0,0,0,0,0,0,0,0,0,0,0,0,0,0,0,0,0,0,0,0,0,0,0,0,0,0,0,0,0,0,0,0,0,0,0,0,0,0,0,0,0,0,0
0,0,0,0,0,0,0,0,0,0,0,0,0,0,0,0,0,0,0,0,0,0,0,0,0,0,0,0,0,0,0,0,0,0,0,0,0,0,8,8,8,8,8,8,8,8,8,0,0,0,0,0,0,0,0,0,0,0,0,0,0,0,0,0,0,0,0,0,0,0,0,0,0,0,0,0,0,0,0,0,0,0,0,0,0,0,0,0,0,0,0,0,0,0,0,0,0,0,0,0,0,0,0,0,0,0,0,0,0,0,0,0,0,0,0,0,0,0,0,0,0,0,0,0,0,0
0,0,0,0,0,0,0,0,0,0,0,0,0,0,0,0,0,0,0,0,0,0,0,0,0,0,0,0,0,0,0,0,0,0,0,0,0,0,8,57,57,57,57,57,57,57,63,8,8,8,8,8,8,8,0,0,0,0,0,0,0,0,0,0,0,0,0,0,0,0,0,0,0,0,0,0,0,0,0,0,0,0,0,0,0,0,0,0,0,0,0,0,0,0,0,0,0,0,0,0,0,0,0,0,0,0,0,0,0,0,0,0,0,0,0,0,0,0,0,0,0,0,0,0,0,0
0,0,0,0,0,0,0,0,0,0,0,0,0,0,0,0,0,0,0,0,0,0,0,0,0,0,0,0,0,0,0,0,0,0,0,0,0,0,8,57,57,57,57,57,57,57,57,57,57,57,-57,-57,-57,-57,0,0,0,0,0,0,0,0,0,0,0,0,0,0,0,0,0,0,0,0,0,0,0,0,0,0,0,0,0,0,0,0,0,0,0,0,0,0,0,0,0,0,0,0,0,0,0,0,0,0,0,0,0,0,0,0,0,0,0,0,0,0,0,0,0,0,0,0,0,0,0,0
0,0,0,0,0,0,0,0,0,0,0,0,0,0,0,0,0,0,0,0,0,0,0,0,0,0,0,0,0,0,0,0,0,0,0,0,0,0,8,57,57,57,57,57,57,57,57,57,57,57,-57,-44,-44,-57,0,0,0,0,0,0,0,0,0,0,0,0,0,0,0,0,0,0,0,0,0,0,0,0,0,0,0,0,0,0,0,0,0,0,0,0,0,0,0,0,0,0,0,0,0,0,0,0,0,0,0,0,0,0,0,0,0,0,0,0,0,0,0,0,0,0,0,0,0,0,0,0
0,0,0,0,0,0,0,0,0,0,0,0,0,0,0,0,0,0,0,0,0,0,0,0,0,0,0,0,0,0,0,0,0,0,0,0,0,8,62,57,57,57,57,57,57,57,57,57,57,57,-57,-57,-57,-57,0,0,0,0,0,0,0,0,0,0,0,0,0,0,0,0,0,0,0,0,0,0,0,0,0,0,0,0,0,0,0,0,0,0,0,0,0,0,0,0,0,0,0,0,0,0,0,0,0,0,0,0,0,0,0,0,0,0,0,0,0,0,0,0,0,0,0,0,0,0,0,0
0,0,0,0,0,0,0,0,0,0,0,0,0,0,0,0,0,0,0,0,0,0,0,0,0,0,0,0,0,0,0,0,0,0,0,0,0,8,57,57,57,57,57,57,57,57,57,57,57,57,57,57,57,57,0,0,0,0,0,0,0,0,0,0,0,0,0,0,0,0,0,0,0,0,0,0,0,0,0,0,0,0,0,0,0,0,0,0,0,0,0,0,0,0,0,0,0,0,0,0,0,0,0,0,0,0,0,0,0,0,0,0,0,0,0,0,0,0,0,0,0,0,0,0,0,0
0,0,0,0,0,0,0,0,0,0,0,0,0,0,0,0,0,0,0,0,0,0,0,0,0,0,0,0,0,0,0,0,0,0,0,0,0,8,57,57,57,57,57,57,57,57,57,57,8,8,8,8,8,8,0,0,0,0,0,0,0,0,0,0,0,0,0,0,0,0,0,0,0,0,0,0,0,0,0,0,0,0,0,0,0,0,0,0,0,0,0,0,0,0,0,0,0,0,0,0,0,0,0,0,0,0,0,0,0,0,0,0,0,0,0,0,0,0,0,0,0,0,0,0,0,0
0,0,0,0,0,0,0,0,0,0,0,0,0,0,0,0,0,0,0,0,0,0,0,0,0,0,0,0,0,0,0,0,0,0,0,0,0,8,57,57,57,57,57,57,57,57,57,57,8,0,0,0,0,0,0,0,0,0,0,0,0,0,0,0,0,0,0,0,0,0,0,0,0,0,0,0,0,0,0,0,0,0,0,0,0,0,0,0,0,0,0,0,0,0,0,0,0,0,0,0,0,0,0,0,0,0,0,0,0,0,0,0,0,0,0,0,0,0,0,0,0,0,0,0,0,0
0,0,0,0,0,0,0,0,0,0,0,0,0,0,0,0,0,0,0,0,0,0,0,0,0,0,0,0,0,0,0,0,0,0,0,0,0,8,57,57,-57,57,57,57,-57,57,57,57,8,0,0,0,0,0,0,0,0,0,0,0,0,0,0,0,0,0,0,0,0,0,0,0,0,0,0,0,0,0,0,0,0,0,0,0,0,0,0,0,0,0,0,0,0,0,0,0,0,0,0,0,0,0,0,0,0,0,0,0,0,0,0,0,0,0,0,0,0,0,0,0,0,0,0,0,0,0
0,0,0,0,0,0,0,0,0,0,0,0,0,0,0,0,0,0,0,0,0,0,0,0,0,0,0,0,0,0,0,0,0,0,0,0,0,8,8,8,-8,60,60,60,-8,8,8,8,8,0,0,0,0,0,0,0,0,0,0,0,0,0,0,0,0,0,0,0,0,0,0,0,0,0,0,0,0,0,0,0,0,0,0,0,0,0,0,0,0,0,0,0,0,0,0,0,0,0,0,0,0,0,0,0,0,0,0,0,0,0,0,0,0,0,0,0,0,0,0,0,0,0,0,0,0,0
0,0,0,0,0,0,0,0,0,0,0,0,0,0,0,0,0,0,0,0,0,0,0,0,0,0,0,0,0,0,0,0,0,0,0,0,0,0,0,0,-8,60,60,60,-8,0,0,0,0,0,0,0,0,0,0,0,0,0,0,0,0,0,0,0,0,0,0,0,0,0,0,0,0,0,0,0,0,0,0,0,0,0,0,0,0,0,0,0,0,0,0,0,0,0,0,0,0,0,0,0,0,0,0,0,0,0,0,0,0,0,0,0,0,0,0,0,0,0,0,0,0,0,0,0,0,0
0,0,0,0,0,8,8,8,8,8,0,0,0,0,0,0,0,0,0,0,0,0,0,0,0,0,0,0,0,0,0,0,0,0,0,0,0,0,0,0,-8,60,60,60,-8,0,0,0,0,0,0,0,0,0,0,0,0,0,0,0,0,0,0,0,0,0,0,0,0,0,0,0,0,0,0,0,0,0,0,0,0,0,0,0,0,0,0,0,0,0,0,0,0,0,0,0,0,0,0,0,0,0,0,0,0,0,0,0,0,0,0,0,0,0,0,0,0,0,0,0,0,0,0,0,0,0
0,0,0,0,0,8,57,57,57,8,0,0,0,0,0,0,0,0,0,0,0,0,0,0,0,0,0,0,0,0,0,0,0,0,0,0,0,0,0,0,-8,60,60,60,-8,0,0,0,0,0,0,0,0,0,0,0,0,0,0,0,0,0,0,0,0,0,0,0,0,0,0,0,0,0,0,0,0,0,0,0,0,0,0,0,0,0,0,0,0,0,0,0,0,0,0,0,0,0,0,0,0,0,0,0,0,0,0,0,0,0,0,0,0,0,0,0,0,0,0,0,0,0,0,0,0,0
0,0,0,0,0,8,57,57,57,8,0,0,0,0,0,0,0,0,0,0,0,0,0,0,0,0,0,0,0,0,0,0,0,0,0,0,0,0,0,0,-8,60,60,60,-8,0,0,0,0,0,0,0,0,0,0,0,0,0,0,0,0,0,0,0,0,0,0,0,0,0,0,0,0,0,0,0,0,0,0,0,0,0,0,0,0,0,0,0,0,0,0,0,0,0,0,0,0,0,0,0,0,0,0,0,0,0,0,0,0,0,0,0,0,0,0,0,0,0,0,0,0,0,0,0,0,0
0,0,0,0,0,8,57,57,57,8,0,0,0,0,0,0,0,0,0,0,0,0,0,0,0,0,0,0,0,0,0,0,0,0,0,0,0,0,0,0,-8,60,60,60,-8,0,0,0,0,0,0,0,0,0,0,0,0,0,0,0,0,0,0,0,0,0,0,0,0,0,0,0,0,0,0,0,0,0,0,0,0,0,0,0,0,0,0,0,0,0,0,0,0,0,0,0,0,0,0,0,0,0,0,0,0,0,0,0,0,0,0,0,0,0,0,0,0,0,0,0,0,0,0,0,0,0
0,0,0,0,0,8,8,8,8,8,0,0,0,0,0,0,0,0,0,0,0,0,0,0,0,0,0,0,0,0,0,0,0,0,0,0,0,0,0,0,-8,60,60,60,-8,0,0,0,0,0,0,0,0,0,0,0,0,0,0,0,0,0,0,0,0,0,0,0,0,0,0,0,0,0,0,0,0,0,0,0,0,0,0,0,0,0,0,0,0,0,0,0,0,0,0,0,0,0,0,0,0,0,0,0,0,0,0,0,0,0,0,0,0,0,0,0,0,0,0,0,0,0,0,0,0,0
0,0,0,0,0,0,0,0,0,0,0,0,0,0,0,0,0,0,0,0,0,0,0,0,0,0,0,0,0,0,0,0,0,0,0,0,0,0,0,0,-8,60,60,60,-8,0,0,0,0,0,0,0,0,0,0,0,0,0,0,0,0,0,0,0,0,0,0,0,0,0,0,0,0,0,0,0,0,0,0,0,0,0,0,0,0,0,0,0,0,0,0,0,0,0,0,0,0,0,0,0,0,0,0,0,0,0,0,0,0,0,0,0,0,0,0,0,0,0,0,0,0,0,0,0,0,0
0,0,0,0,0,0,0,0,0,0,0,0,0,0,0,0,0,0,0,0,0,0,0,0,0,0,0,0,0,0,0,0,0,0,0,0,0,0,0,0,-8,60,60,60,-8,0,0,0,0,0,0,0,0,0,0,0,0,0,0,0,0,0,0,0,0,0,0,0,0,0,0,0,0,0,0,0,0,0,0,0,0,0,0,0,0,0,0,0,0,0,0,0,0,0,0,0,0,0,0,0,0,0,0,0,0,0,0,0,0,0,0,0,0,0,0,0,0,0,0,0,0,0,0,0,0,0
0,0,0,0,0,0,0,0,0,0,0,0,0,0,0,0,0,0,0,0,0,0,0,0,0,0,0,0,0,0,0,0,0,0,0,0,0,0,0,0,-8,60,60,60,-8,0,0,0,0,0,0,0,0,0,0,0,0,0,0,0,0,0,0,0,0,0,0,0,0,0,0,0,0,0,0,0,0,0,0,0,0,0,0,0,0,0,0,0,0,0,0,0,0,0,0,0,0,0,0,0,0,0,0,0,0,0,0,0,0,0,0,0,0,0,0,0,0,0,0,0,0,0,0,0,0,0
0,0,0,0,0,0,0,0,0,0,0,0,0,0,0,0,0,0,0,0,0,0,0,0,0,0,0,0,0,0,0,0,0,0,0,0,0,0,0,0,-8,60,60,60,-8,0,0,0,0,0,0,0,0,0,0,0,0,0,0,0,0,0,0,0,0,0,0,0,0,0,0,0,0,0,0,0,0,0,0,0,0,0,0,0,0,0,0,0,0,0,0,0,0,0,0,0,0,0,0,0,0,0,0,0,0,0,0,0,0,0,0,0,0,0,0,0,0,0,0,0,0,0,0,0,0,0
0,0,0,0,0,0,0,0,0,0,0,0,0,0,0,0,0,0,0,0,0,0,0,0,0,0,0,0,0,0,0,0,0,0,0,0,0,0,0,0,-8,60,60,60,-8,0,0,0,0,0,0,0,0,0,0,0,0,0,0,0,0,0,0,0,0,0,0,0,0,0,0,0,0,0,0,0,0,0,0,0,0,0,0,0,0,0,0,0,0,0,0,0,0,0,0,0,0,0,0,0,0,0,0,0,0,0,0,0,0,0,0,0,0,0,0,0,0,0,0,0,0,0,0,0,0,0
0,0,0,0,0,0,0,0,0,0,0,0,0,0,0,0,0,0,0,0,0,0,0,0,0,0,0,0,0,0,0,0,0,0,0,0,0,0,0,0,-8,60,60,60,-8,0,0,0,0,0,0,0,0,0,0,0,0,0,0,0,0,0,0,0,0,0,0,0,0,0,0,0,0,0,0,0,0,0,0,0,0,0,0,0,0,0,0,0,0,0,0,0,0,0,0,0,0,0,0,0,0,0,0,0,0,0,0,0,0,0,0,0,0,0,0,0,0,0,0,0,0,0,0,0,0,0
0,0,0,0,0,0,0,0,0,0,0,0,0,0,0,0,0,0,0,0,0,0,0,0,0,0,0,0,0,0,0,0,0,0,0,0,0,0,0,0,-8,60,60,60,-8,0,0,0,0,0,0,0,0,0,0,0,0,0,0,0,0,0,0,0,0,0,0,0,0,0,0,0,0,0,0,0,0,0,0,0,0,0,0,0,0,0,0,0,0,0,0,0,0,0,0,0,0,0,0,0,0,0,0,0,0,0,0,0,0,0,0,0,0,0,0,0,0,0,0,0,0,0,0,0,0,0
0,0,0,0,0,0,0,0,0,0,0,0,0,0,0,0,0,0,0,0,0,0,0,0,0,0,0,0,0,0,0,0,0,0,0,0,0,0,0,0,-8,60,60,60,-8,0,0,0,0,0,0,0,0,0,0,0,0,0,0,0,0,0,0,0,0,0,0,0,0,0,0,0,0,0,0,0,0,0,0,0,0,0,0,0,0,0,0,0,0,0,0,0,0,0,0,0,0,0,0,0,0,0,0,0,0,0,0,0,0,0,0,0,0,0,0,0,0,0,0,0,0,0,0,0,0,0
0,0,0,0,0,0,0,0,0,0,0,0,0,0,0,0,0,0,0,0,0,0,0,0,0,0,0,0,0,0,0,0,0,0,0,0,0,0,0,0,-8,60,60,60,-8,0,0,0,0,0,0,0,0,0,0,0,0,0,0,0,0,0,0,0,0,0,0,0,0,0,0,0,0,0,0,0,0,0,0,0,0,0,0,0,0,0,0,0,0,0,0,0,0,0,0,0,0,0,0,0,0,0,0,0,0,0,0,0,0,0,0,0,0,0,0,0,0,0,0,0,0,0,0,0,0,0
0,0,0,0,0,0,0,0,0,0,0,0,0,0,0,0,0,0,0,0,0,0,0,0,0,0,0,0,0,0,0,0,0,0,0,0,0,0,0,0,-8,60,60,60,-8,0,0,0,0,0,0,0,0,0,0,0,0,0,0,0,0,0,0,0,0,0,0,0,0,0,0,0,0,0,0,0,0,0,0,0,0,0,0,0,0,0,0,0,0,0,0,0,0,0,0,0,0,0,0,0,0,0,0,0,0,0,0,0,0,0,0,0,0,0,0,0,0,0,0,0,0,0,0,0,0,0
0,0,0,0,0,0,0,0,0,0,0,0,0,0,0,0,0,0,0,0,0,0,0,0,0,0,0,0,0,0,0,0,0,0,0,0,0,0,0,0,-8,60,60,60,-8,0,0,0,0,0,0,0,0,0,0,0,0,0,0,0,0,0,0,0,0,0,0,0,0,0,0,0,0,0,0,0,0,0,0,0,0,0,0,0,0,0,0,0,0,0,0,0,0,0,0,0,0,0,0,0,0,0,0,0,0,0,0,0,0,0,0,0,0,0,0,0,0,0,0,0,0,0,0,0,0,0
0,0,0,0,0,0,0,0,0,0,0,0,0,0,0,0,0,0,0,0,0,0,0,0,0,0,0,0,0,0,0,0,0,0,0,0,0,0,0,0,-8,60,60,60,-8,0,0,0,0,0,0,0,0,0,0,0,0,0,0,0,0,0,0,0,0,0,0,0,0,0,0,0,0,0,0,0,0,0,0,0,0,0,0,0,0,0,0,0,0,0,0,0,0,0,0,0,0,0,0,0,0,0,0,0,0,0,0,0,0,0,0,0,0,0,0,0,0,0,0,0,0,0,0,0,0,0
0,0,0,0,0,0,0,0,0,0,0,0,0,0,0,0,0,0,0,0,0,0,0,0,0,0,0,0,0,0,0,0,0,0,0,0,0,0,0,0,-8,60,60,60,-8,0,0,0,0,0,0,0,0,0,0,0,0,0,0,0,0,0,0,0,0,0,0,0,0,0,0,0,0,0,0,0,0,0,0,0,0,0,0,0,0,0,0,0,0,0,0,0,0,0,0,0,0,0,0,0,0,0,0,0,0,0,0,0,0,0,0,0,0,0,0,0,0,0,0,0,0,0,0,0,0,0
0,0,0,0,0,0,0,0,0,0,0,0,0,0,0,0,0,0,0,0,0,0,0,0,0,0,0,0,0,0,0,0,0,0,0,0,0,0,0,0,-8,60,60,60,-8,0,0,0,0,0,0,0,0,0,0,0,0,0,0,0,0,0,0,0,0,0,0,0,0,0,0,0,0,0,0,0,0,0,0,0,0,0,0,0,0,0,0,0,0,0,0,0,0,0,0,0,0,0,0,0,0,0,0,0,0,0,0,0,0,0,0,0,0,0,0,0,0,0,0,0,0,0,0,0,0,0
0,0,0,0,0,0,0,0,0,0,0,0,0,0,0,0,0,0,0,0,0,0,0,0,0,0,0,0,0,0,0,0,0,0,0,0,0,0,0,0,-8,60,60,60,-8,0,0,0,0,0,0,0,0,0,0,0,0,0,0,0,0,0,0,0,0,0,0,0,0,0,0,0,0,0,0,0,0,0,0,0,0,0,0,0,0,0,0,0,0,0,0,0,0,0,0,0,0,0,0,0,0,0,0,0,0,0,0,0,0,0,0,0,0,0,0,0,0,0,0,0,0,0,0,0,0,0
0,0,0,0,0,0,0,0,0,0,0,0,0,0,0,0,0,0,0,0,0,8,8,8,8,8,8,54,8,8,8,8,8,8,8,8,8,8,8,8,-8,54,54,54,-8,8,8,8,8,8,8,8,8,8,8,8,8,8,8,8,8,0,0,0,0,0,0,0,0,0,0,0,0,0,0,0,0,0,0,0,0,0,0,0,0,0,0,0,0,0,0,0,0,0,0,0,0,0,0,0,0,0,0,0,0,0,0,0,0,0,0,0,0,0,0,0,0,0,0,0,0,0,0,0,0,0
0,0,0,0,0,0,0,0,0,0,0,0,0,0,0,0,0,0,0,8,8,62,57,57,57,57,57,57,57,57,57,57,57,57,57,57,57,57,57,57,-57,57,57,57,-57,57,57,57,57,57,57,57,57,57,57,57,57,57,57,57,63,8,8,8,0,0,0,0,0,0,0,0,0,0,0,0,0,0,0,0,0,0,0,0,0,0,0,0,0,0,0,0,0,0,0,0,0,0,0,0,0,0,0,0,0,0,0,0,0,0,0,0,0,0,0,0,0,0,0,0,0,0,0,0,0,0
0,0,0,0,0,0,0,0,0,0,0,0,0,0,0,0,0,0,8,62,57,57,57,57,57,57,57,57,57,57,57,57,57,57,57,57,57,57,57,57,-57,57,57,57,-57,57,57,57,57,57,57,57,57,57,57,57,57,57,57,57,57,57,57,63,8,0,0,0,0,0,0,0,0,0,0,0,0,0,0,0,0,0,0,0,0,0,0,0,0,0,0,0,0,0,0,0,0,0,0,0,0,0,0,0,0,0,0,0,0,0,0,0,0,0,0,0,0,0,0,0,0,0,0,0,0,0
0,0,0,0,0,0,0,0,0,0,0,0,0,0,0,-8,-8,-8,-57,-57,-57,-57,-57,-57,-57,-57,-57,-57,-57,-57,-57,-57,33,34,-57,-57,-57,-57,-57,-57,-57,41,41,41,-57,-57,-57,-57,-57,-57,-57,33,34,-57,-57,-57,-57,-57,-57,-57,-57,-57,-57,-57,-57,-8,-8,-8,-8,-8,-8,0,0,0,0,0,0,0,0,0,0,0,0,0,0,0,0,0,0,0,0,0,0,0,0,0,0,0,0,0,0,0,0,0,0,0,0,0,0,0,0,0,0,0,0,0,0,0,0,0,0,0,0,0,0,0
0,0,0,0,0,0,0,0,0,0,0,0,0,0,-8,-8,4,2,4,4,2,3,4,4,3,4,4,2,4,3,3,4,3,3,2,3,3,2,2,4,78,79,79,79,80,4,2,4,4,3,3,3,3,3,3,3,3,3,3,3,3,3,3,3,3,3,3,3,3,3,-8,-8,-8,0,0,0,0,0,0,0,0,0,0,0,0,0,0,0,0,0,0,0,0,0,0,0,0,0,0,0,0,0,0,0,0,0,0,0,0,0,0,0,0,0,0,0,0,0,0,0,0,0,0,0,0,0
0,0,0,0,0,0,0,0,0,0,0,0,0,0,-8,3,3,3,3,4,2,3,4,4,3,4,4,2,4,3,3,4,3,3,2,75,76,76,76,76,84,79,79,79,85,76,76,76,76,77,4,4,4,4,4,4,4,4,4,4,4,4,4,4,4,4,4,4,4,4,2,3,-8,0,0,0,0,0,0,0,0,0,0,0,0,0,0,0,0,0,0,0,0,0,0,0,0,0,0,0,0,0,0,0,0,0,0,0,0,0,0,0,0,0,0,0,0,0,0,0,0,0,0,0,0,0
0,0,0,0,0,0,0,0,0,0,0,0,0,0,-8,2,2,2,2,4,2,3,4,4,3,4,4,2,4,3,3,4,3,3,2,78,79,79,79,79,79,79,79,79,79,79,79,79,79,80,2,2,2,2,2,2,2,2,2,2,2,2,2,2,2,2,2,2,2,2,3,2,-8,0,0,0,0,0,0,0,0,0,0,0,0,0,0,0,0,0,0,0,0,0,0,0,0,0,0,0,0,0,0,0,0,0,0,0,0,0,0,0,0,0,0,0,0,0,0,0,0,0,0,0,0,0
0,0,0,0,0,0,0,0,0,0,0,0,0,0,-8,2,2,2,2,4,2,3,4,4,3,4,4,2,4,3,3,4,3,3,2,78,79,87,82,82,82,82,82,82,82,82,82,86,79,80,4,4,4,4,4,4,4,4,4,4,4,4,4,4,4,4,4,4,4,4,3,2,-8,0,0,0,0,0,0,0,0,0,0,0,0,0,0,0,0,0,0,0,0,0,0,0,0,0,0,0,0,0,0,0,0,0,0,0,0,0,0,0,0,0,0,0,0,0,0,0,0,0,0,0,0,0
0,0,0,0,0,0,0,0,0,0,0,0,0,0,-8,2,2,2,2,4,3,2,4,3,3,3,2,2,2,3,2,4,3,2,4,78,79,80,2,-4,-4,-4,-4,-4,-4,-4,2,78,79,80,2,2,3,2,2,4,3,2,4,2,2,2,2,3,3,2,4,4,4,4,3,4,-8,0,0,0,0,0,0,0,0,0,0,0,0,0,0,0,0,0,0,0,0,0,0,0,0,0,0,0,0,0,0,0,0,0,0,0,0,0,0,0,0,0,0,0,0,0,0,0,0,0,0,0,0,0
0,0,0,0,0,0,0,0,0,0,0,0,0,-8,-8,3,3,3,3,3,3,4,2,4,3,3,2,3,2,4,-4,-4,-4,-4,-4,78,79,80,4,-4,-4,-4,-4,-4,-4,-4,2,78,79,80,4,4,4,4,3,2,4,4,3,4,2,3,3,4,3,2,3,3,3,3,3,4,-8,0,0,0,0,0,0,0,0,0,0,0,0,0,0,0,0,0,0,0,0,0,0,0,0,0,0,0,0,0,0,0,0,0,0,0,0,0,0,0,0,0,0,0,0,0,0,0,0,0,0,0,0,0
0,0,0,0,0,0,0,0,0,0,0,0,0,-8,3,2,2,2,2,3,4,4,3,2,2,2,3,2,3,3,-4,-4,-4,-4,-4,78,79,80,4,-4,-4,-4,-4,-4,-4,-4,2,78,79,80,-4,-4,-4,-4,4,4,3,2,2,2,2,2,2,3,3,2,4,4,4,4,3,3,-8,0,0,0,0,0,0,0,0,0,0,0,0,0,0,0,0,0,0,0,0,0,0,0,0,0,0,0,0,0,0,0,0,0,0,0,0,0,0,0,0,0,0,0,0,0,0,0,0,0,0,0,0,0
0,0,0,0,0,0,0,0,0,0,0,0,0,-8,2,2,2,2,2,3,3,2,3,4,4,3,4,4,2,3,-4,-4,-4,-4,-4,78,79,80,2,-4,-4,-4,-4,-4,-4,-4,2,78,79,80,-4,-4,-4,-4,2,4,2,2,3,2,2,2,2,3,4,3,4,4,4,4,2,3,-8,0,0,0,0,0,0,0,0,0,0,0,0,0,0,0,0,0,0,0,0,0,0,0,0,0,0,0,0,0,0,0,0,0,0,0,0,0,0,0,0,0,0,0,0,0,0,0,0,0,0,0,0,0
0,0,0,0,0,0,0,0,0,0,0,0,0,-8,2,2,2,2,2,4,3,3,4,2,3,3,2,3,2,3,-4,-4,3,-4,-4,78,79,80,-4,4,2,-4,4,-4,4,3,2,78,79,80,-4,-4,4,-4,4,4,2,4,4,4,2,4,3,2,4,4,3,3,3,3,2,2,-8,0,0,0,0,0,0,0,0,0,0,0,0,0,0,0,0,0,0,0,0,0,0,0,0,0,0,0,0,0,0,0,0,0,0,0,0,0,0,0,0,0,0,0,0,0,0,0,0,0,0,0,0,0
0,0,0,0,0,0,0,0,0,0,0,0,0,-8,3,2,2,2,2,3,4,3,2,4,3,2,4,75,76,76,76,76,76,76,76,84,79,85,76,76,76,76,76,76,76,76,76,84,79,85,76,76,76,76,76,76,76,77,2,3,2,4,3,3,3,3,4,4,4,4,3,2,-8,0,0,0,0,0,0,0,0,0,0,0,0,0,0,0,0,0,0,0,0,0,0,0,0,0,0,0,0,0,0,0,0,0,0,0,0,0,0,0,0,0,0,0,0,0,0,0,0,0,0,0,0,0
0,0,0,0,0,0,0,0,0,0,0,0,0,-8,2,2,2,2,2,2,4,4,2,4,3,4,4,78,79,79,79,79,79,79,79,79,79,79,79,79,79,79,79,79,79,79,79,79,79,79,79,79,79,79,79,79,79,80,3,2,3,3,4,2,4,3,4,4,4,4,2,4,-8,0,0,0,0,0,0,0,0,0,0,0,0,0,0,0,0,0,0,0,0,0,0,0,0,0,0,0,0,0,0,0,0,0,0,0,0,0,0,0,0,0,0,0,0,0,0,0,0,0,0,0,0,0
0,0,0,0,0,0,0,0,0,0,0,0,0,-8,3,3,3,3,3,4,3,2,4,2,3,4,2,78,79,87,82,82,82,82,82,82,82,82,82,82,82,82,82,82,82,82,82,82,82,82,82,82,82,82,82,86,79,80,3,3,3,2,3,2,2,2,3,3,3,3,4,2,-8,0,0,0,0,0,0,0,0,0,0,0,0,0,0,0,0,0,0,0,0,0,0,0,0,0,0,0,0,0,0,0,0,0,0,0,0,0,0,0,0,0,0,0,0,0,0,0,0,0,0,0,0,0
-8,-8,-8,0,0,0,0,0,0,0,0,0,0,-8,3,3,3,3,3,4,4,3,2,2,3,2,3,78,79,80,2,2,1,1,1,1,1,1,1,1,1,1,1,1,1,1,1,1,1,1,1,1,1,2,4,78,79,80,4,4,2,3,3,4,3,2,3,3,3,3,3,3,-8,0,0,0,0,0,0,0,0,0,0,0,0,0,0,0,0,0,0,0,0,0,0,0,0,0,0,0,0,0,0,0,0,0,0,0,0,0,0,0,0,0,0,0,0,0,0,0,0,0,0,0,0,0
-4,-4,-8,-8,-8,-8,-8,-8,-8,-8,-8,-8,-8,-8,2,2,2,2,2,2,4,4,4,4,3,4,4,78,79,80,2,2,1,1,1,1,1,1,1,1,1,1,1,1,1,1,1,1,1,1,1,1,1,4,2,78,79,80,2,3,3,2,2,4,2,3,4,4,4,4,3,4,-8,0,0,0,0,0,0,0,0,0,0,0,0,0,0,0,0,0,0,0,0,0,0,0,0,0,0,0,0,0,0,0,0,0,0,0,0,0,0,0,0,0,0,0,0,0,0,0,0,0,0,0,0,0
-4,-4,5,3,5,5,5,5,3,5,2,5,5,5,3,3,3,3,3,3,4,3,4,2,4,4,2,78,79,80,3,2,1,1,1,1,1,1,1,1,1,1,1,1,1,1,1,1,1,1,1,1,1,3,2,78,79,80,3,4,4,2,3,3,2,4,3,3,3,3,3,4,-8,0,0,0,0,0,0,0,0,0,0,0,0,0,0,0,0,0,0,0,0,0,0,0,0,0,0,0,0,0,0,0,0,0,0,0,0,0,0,0,0,0,0,0,0,0,0,0,0,0,0,0,0,0
-44,-4,5,3,5,5,5,5,3,5,2,5,5,5,2,2,2,2,2,2,3,3,3,4,2,3,2,78,79,80,2,3,1,1,1,3,3,3,3,3,-4,-4,-4,-4,-4,4,4,4,4,4,1,1,1,4,3,78,79,80,3,4,2,2,2,4,4,4,4,4,4,4,2,4,-8,-8,-8,-8,-8,-8,-8,-8,-8,-8,-8,-8,-8,-8,-8,-8,-8,-8,-8,-8,-8,-8,-8,-8,-8,-8,-8,-8,-8,-8,-8,-8,-8,-8,-8,-8,-8,-8,-8,-8,-8,-8,0,0,0,0,0,0,0,0,0,0,0,0
-44,-4,3,5,5,5,5,5,5,4,5,5,4,5,3,2,2,2,2,2,-2,-2,-2,-2,-2,-2,2,78,79,80,2,3,1,1,1,3,-66,-67,-68,3,-4,-4,-4,-4,-4,4,-66,-67,-68,2,1,1,1,4,2,78,79,80,2,-2,-2,-2,-2,-2,-2,4,2,2,2,2,4,4,4,2,3,2,3,2,2,90,90,90,90,90,90,90,90,90,90,-2,-2,-2,-2,-2,-2,90,90,90,90,90,90,90,90,90,90,90,90,90,90,90,90,90,90,-8,-8,0,0,0,0,0,0,0,0,0,0,0
-44,-4,5,5,5,3,5,5,5,5,5,5,5,3,5,3,3,3,3,2,-2,-2,-2,-2,-2,-2,3,78,79,80,2,3,1,1,1,3,-69,-70,-71,2,-4,-4,-4,-4,-4,2,-69,-70,-71,4,1,1,1,3,3,78,79,80,4,-2,-2,-2,-2,-2,-2,2,2,2,2,2,4,2,3,2,2,2,3,2,90,90,90,90,90,90,90,90,90,90,90,-2,-2,-2,-2,-2,-2,90,90,90,90,90,90,90,90,90,90,90,90,90,90,90,90,90,90,90,-8,-8,0,0,0,0,0,0,0,0,0,0
-44,-4,5,5,5,5,5,4,5,2,5,5,5,5,4,2,2,2,2,2,-2,-2,3,-2,-2,-2,2,78,79,80,4,3,1,1,1,2,-72,-73,-74,2,-4,-4,3,-4,-4,2,-72,-73,-74,4,1,1,1,4,4,78,79,80,4,-2,-2,3,-2,-2,-2,4,3,3,3,3,3,3,2,3,3,3,3,90,90,90,90,90,90,90,90,90,90,90,90,-2,-2,2,-2,-2,-2,90,90,90,90,90,90,90,90,90,90,90,90,90,90,90,90,90,90,90,90,-8,0,0,0,0,0,0,0,0,0,0
-44,-4,21,21,21,21,21,21,21,21,21,21,22,2,75,76,76,76,76,76,76,76,76,76,76,76,76,84,79,85,76,76,76,76,76,76,76,76,76,76,76,76,76,76,76,76,76,76,76,76,76,76,76,76,76,84,79,85,76,76,76,76,76,76,76,76,76,76,76,76,76,3,20,21,21,21,21,21,21,21,21,21,21,21,21,21,21,21,21,21,21,21,21,21,21,21,21,21,21,21,21,21,21,21,21,21,21,21,21,21,21,21,22,90,90,-8,0,0,0,0,0,0,0,0,0,0
-44,4,24,24,24,24,24,24,24,24,24,24,25,3,78,79,79,79,79,79,79,79,79,79,79,79,79,79,79,79,79,79,79,79,79,79,79,79,79,79,79,79,79,79,79,79,79,79,79,79,79,79,79,79,79,79,79,79,79,79,79,79,79,79,79,79,79,79,79,79,79,2,23,24,24,24,24,24,24,24,24,24,24,24,24,24,24,24,24,24,24,24,24,24,24,24,24,24,24,24,24,24,24,24,24,24,24,24,24,24,24,24,25,90,2,-8,0,0,0,0,0,0,0,0,0,0
-44,-4,27,27,27,27,27,27,27,27,27,27,28,3,81,82,86,79,87,82,82,82,82,82,82,82,82,86,79,87,82,82,82,82,82,82,82,82,82,82,82,82,82,82,82,82,82,82,82,82,82,82,82,82,82,86,79,87,82,82,82,82,82,82,82,82,86,79,87,82,82,3,26,27,27,27,27,27,27,27,27,27,27,27,27,27,27,27,27,27,27,27,27,27,27,27,27,27,27,27,27,27,27,27,27,27,27,27,27,27,31,24,25,2,2,-8,0,0,0,0,0,0,0,0,0,0
-44,-4,-100,-100,-100,-100,5,5,5,5,-100,-100,-100,-100,-103,3,78,79,80,4,3,3,2,2,2,2,3,78,79,80,-91,-91,4,4,4,4,4,4,4,4,4,4,4,4,4,4,4,4,4,4,4,4,4,-91,-91,78,79,80,2,3,3,3,4,4,2,4,78,79,80,2,4,3,4,3,3,3,3,5,3,5,5,5,3,4,2,2,2,2,2,5,2,2,5,2,2,2,5,2,2,2,2,2,2,5,2,2,2,2,2,2,23,24,25,2,2,-8,0,0,0,0,0,0,0,0,0,0
-44,-4,5,5,5,5,4,5,5,5,5,5,5,5,-104,2,78,79,80,4,2,4,4,4,3,3,3,78,79,80,-91,4,4,-91,-91,4,-91,-91,4,4,-91,-91,4,-91,-91,4,4,-91,-91,4,-91,-91,4,4,-91,78,79,80,3,3,3,3,3,3,3,3,78,79,80,2,4,2,3,2,2,2,2,2,5,5,5,5,5,5,5,5,5,5,5,5,5,5,5,2,5,5,5,5,5,5,5,5,5,2,5,5,5,2,5,2,23,24,25,2,2,-8,0,0,0,0,0,0,0,0,0,0
-44,-4,5,5,5,5,5,5,5,5,5,5,5,5,-104,3,78,79,80,4,2,4,4,4,3,3,3,78,79,80,-91,4,4,-91,-91,4,-91,-91,4,4,-91,4,4,4,-91,4,4,-91,-91,4,-91,-91,4,4,-91,78,79,80,3,3,3,3,3,3,3,3,78,79,80,4,3,2,3,3,3,3,3,5,5,3,5,5,5,5,5,5,5,5,5,2,5,5,5,5,5,2,5,5,2,5,5,2,5,5,2,5,2,5,2,5,23,24,25,2,2,-8,0,0,0,0,0,0,0,0,0,0
-44,-4,5,2,5,5,5,5,5,5,3,5,5,5,-104,3,78,79,80,4,2,4,4,4,3,3,4,78,79,80,-91,4,4,4,4,4,4,4,4,4,4,4,4,4,4,4,4,4,4,4,4,4,4,4,-91,78,79,80,3,3,3,3,3,3,3,3,78,79,80,3,3,3,2,2,2,2,-4,-4,-4,-4,-4,-4,-4,-4,-4,-4,-4,-4,-4,-4,-4,-4,-4,-4,-4,-4,-4,-4,-4,-4,-4,-4,2,2,2,5,5,5,2,2,23,24,25,2,2,-8,0,0,0,0,0,0,0,0,0,0
-44,-4,-4,-4,-4,-4,-4,-4,-4,-4,-4,-4,-4,-4,-104,2,78,79,80,4,2,4,4,4,3,3,2,78,79,80,-91,4,4,-91,-91,4,-91,-91,4,4,-91,4,4,4,-91,4,4,-91,-91,4,-91,-91,4,4,-91,78,79,80,2,2,2,2,2,2,2,2,78,79,80,3,3,2,4,2,2,2,-4,-4,-4,-4,-4,-4,-4,-4,-4,-4,-4,-4,-4,-4,-4,-4,-4,-4,-4,-4,-4,-4,-4,-4,-4,-4,5,5,5,5,2,2,5,2,23,24,25,2,2,-8,0,0,0,0,0,0,0,0,0,0
-44,-4,-4,-4,-4,-4,-4,-4,-4,-4,-4,-4,-4,-4,-104,2,78,79,80,4,2,4,4,4,3,3,3,78,79,80,-91,4,4,-91,-91,4,-91,-91,4,4,-91,-91,4,-91,-91,4,4,-91,-91,4,-91,-91,4,4,-91,78,79,85,2,4,2,2,3,3,3,3,84,79,80,2,4,2,-4,-4,-4,-4,-4,-4,-4,-4,-4,-4,-4,-4,-4,-4,-4,-4,-4,-4,-4,-4,-4,-4,-4,-4,-4,-4,-4,-4,-4,-4,-4,-4,-4,-4,-4,-4,5,5,23,24,25,2,2,-8,0,0,0,0,0,0,0,0,0,0
-44,-4,-4,-4,-4,-4,-4,-4,-4,-4,-4,-4,-4,-4,-104,3,78,79,80,4,2,4,4,4,3,3,4,78,79,80,-91,-91,4,4,4,4,4,4,4,4,4,4,4,4,4,4,4,4,4,4,4,4,4,-91,-91,78,79,79,2,4,2,2,3,3,3,3,79,79,80,3,2,4,-4,-4,-4,-4,-4,-4,-4,-4,-4,-4,-4,-4,-4,-4,-4,-4,-4,-4,-4,-4,-4,-4,-4,-4,-4,-4,-4,-4,-4,-4,-4,-4,-4,-4,-4,-4,5,5,23,24,25,2,2,-8,0,0,0,0,0,0,0,0,0,0
-44,-4,-4,-4,-4,-4,-4,-4,-4,-4,-4,-4,-4,-4,-104,4,78,79,80,4,2,4,4,4,3,3,4,78,79,85,76,76,76,76,76,76,76,76,76,76,76,76,76,76,76,76,76,76,76,76,76,76,76,76,76,84,79,87,2,4,2,2,3,3,3,3,86,79,80,4,4,2,-4,-4,-4,-4,-4,-4,-4,-4,-4,-4,-4,-4,-4,-4,-4,-4,-4,-4,-4,-4,-4,-4,-4,-4,-4,-4,-4,-4,-4,-4,-4,-4,-4,-4,-4,-4,5,2,23,24,25,2,2,-8,0,0,0,0,0,0,0,0,0,0
-44,-4,-4,-4,-4,-4,-4,-4,-4,-4,-4,-4,-4,-4,-104,3,78,79,80,4,2,4,4,4,3,3,3,78,79,79,79,79,79,79,79,79,79,79,79,79,79,79,79,79,79,79,79,79,79,79,79,79,79,79,79,79,79,80,2,4,2,2,3,3,3,3,78,79,80,4,4,3,-4,-4,-4,-4,-4,-4,-4,-4,-4,-4,-4,-4,-4,-4,-4,-4,-4,-4,-4,-4,-4,-4,-4,-4,-4,-4,-4,-4,-4,-4,-4,-4,-4,-4,-4,-4,5,2,23,24,25,2,2,-8,0,0,0,0,0,0,0,0,0,0
-44,-44,-44,-44,-44,-44,-44,-4,-4,-4,-4,-4,-4,-4,-104,2,78,79,80,4,2,4,4,4,3,3,2,81,82,82,82,82,82,82,82,82,82,82,82,82,82,86,79,87,82,82,82,82,82,82,82,82,82,82,82,82,82,83,2,3,3,3,3,2,3,4,78,79,80,2,2,4,-4,-4,-4,-4,-4,-4,-4,-4,-4,-4,-4,-4,-4,-4,-4,-4,-4,-4,-4,-4,-4,-4,-4,-4,-4,-4,-4,-4,-4,-4,-4,-4,-4,-4,-4,-4,2,5,23,24,25,2,2,-8,0,0,0,0,0,0,0,0,0,0
-44,-44,-44,-44,-44,-44,-44,-4,-4,-4,-4,-4,-4,-4,-104,4,78,79,80,4,2,4,4,4,3,3,4,4,2,3,4,4,4,3,3,4,4,4,2,4,3,78,79,80,4,4,4,4,3,4,3,2,2,3,4,3,4,3,4,3,4,2,2,4,3,4,78,79,80,4,4,2,-4,-4,-4,-4,-4,-4,-4,-4,-4,-4,-4,-4,-4,-4,-4,-4,-4,-4,-4,-4,-4,-4,-4,-4,-4,-4,-4,-4,-4,-4,-4,-4,-4,-4,-4,-4,2,5,23,24,25,2,2,-8,0,0,0,0,0,0,0,0,0,0
-44,-44,-44,-44,-44,-44,-44,-4,-4,-4,-4,-4,-4,-4,-104,3,78,79,80,3,3,2,4,3,3,4,2,3,2,4,3,3,2,4,2,2,2,3,4,2,3,78,79,80,4,3,4,2,2,3,3,4,3,3,4,3,4,2,3,2,4,4,2,3,3,3,78,79,80,4,2,4,-4,-4,-4,-4,-4,-4,-4,-4,-4,-4,-4,-4,-4,-4,-4,-4,-4,-4,-4,-4,-4,-4,-4,-4,-4,-4,-4,-4,-4,-4,-4,-4,-4,-4,-4,-4,5,2,23,24,25,2,2,-8,0,0,0,0,0,0,0,0,0,0
-44,-44,-44,-44,-44,-44,-44,-4,-4,-4,-4,-4,-4,-4,-104,2,78,79,80,-2,-2,-2,-2,-2,-2,-2,-2,-2,-2,-2,-2,4,4,4,-2,-2,-2,-2,-2,-2,2,78,79,80,3,-2,-2,-2,-2,-2,-2,-2,-2,-2,-2,-2,-2,3,4,3,-2,-2,-2,-2,-2,-2,78,79,80,4,2,3,-4,-4,-4,-4,-4,-4,-4,-4,-4,-4,-4,-4,-4,-4,-4,-4,-4,-4,-4,-4,-4,-4,-4,-4,-4,-4,-4,-4,-4,-4,-4,-4,-4,-4,-4,-4,5,5,23,24,25,2,2,-8,0,0,0,0,0,0,0,0,0,0
-44,-44,-44,-44,-44,-44,-44,-4,-4,-4,-4,-4,-4,-4,-104,2,78,79,80,-2,-2,-2,-2,-2,-2,-2,-2,-2,-2,-2,-2,4,2,4,-2,-2,-2,-2,-2,-2,2,78,79,80,4,-2,-2,-2,-2,-2,-2,-2,-2,-2,-2,-2,-2,2,4,3,-2,-2,-2,-2,-2,-2,78,79,80,4,2,4,-4,-4,-4,-4,-4,-4,-4,-4,-4,-4,-4,-4,-4,-4,-4,-4,-4,-4,-4,-4,-4,-4,-4,-4,-4,-4,-4,-4,-4,-4,-4,-4,-4,-4,-4,-4,5,5,23,24,25,2,2,-8,0,0,0,0,0,0,0,0,0,0
-44,-44,-44,-44,-44,-44,-44,-4,-4,-4,-4,-4,-4,-4,-104,3,78,79,80,-2,-2,3,-2,-2,-2,-2,-2,3,-2,-2,-2,2,3,3,-2,-2,3,-2,-2,-2,4,78,79,80,2,-2,-2,3,-2,-2,-2,-2,-2,3,-2,-2,-2,3,3,2,-2,-2,3,-2,-2,-2,78,79,80,2,4,2,-4,-4,-4,-4,-4,-4,-4,-4,-4,-4,-4,-4,-4,-4,-4,-4,-4,-4,-4,-4,-4,-4,-4,-4,-4,-4,-4,-4,-4,-4,-4,-4,-4,-4,-4,-4,5,5,23,24,25,2,2,-8,0,0,0,0,0,0,0,0,0,0
-44,-44,-44,-44,-44,-44,-44,-44,-44,-4,-4,-4,-4,-4,-104,3,78,79,85,76,76,76,76,76,76,76,76,76,76,76,76,76,76,76,76,76,76,76,76,76,76,84,79,85,76,76,76,76,76,76,76,76,76,76,76,76,76,76,76,76,76,76,76,76,76,76,84,79,80,4,3,4,-4,-4,-4,-4,-4,-4,-4,-4,-4,-4,-4,-4,-4,-4,-4,-4,-4,-4,-4,-4,-4,-4,-4,-4,-4,-4,-4,-4,-4,-4,-4,-4,-4,-4,-4,-4,2,5,23,24,25,2,5,-8,-8,0,0,0,0,0,0,0,0,0
-44,-44,-44,-44,-44,-44,-44,-44,-44,-4,-4,-4,-4,-4,-104,4,78,79,79,79,79,79,79,79,79,79,79,79,79,79,79,79,79,79,79,79,79,79,79,79,79,79,79,79,79,79,79,79,79,79,79,79,79,79,79,79,79,79,79,79,79,79,79,79,79,79,79,79,80,3,3,4,-4,-4,-4,-4,-4,-4,-4,-4,-4,-4,-4,-4,-4,-4,-4,-4,-4,-4,-4,-4,-4,-4,-4,-4,-4,-4,-4,-4,-4,-4,-4,-4,-4,-4,-4,-4,5,5,23,24,25,2,5,5,-8,0,0,0,0,0,0,0,0,0
-44,-44,-44,-44,-44,-44,-44,-44,-44,-4,-4,-4,-4,-4,-104,2,81,82,82,82,82,82,82,82,82,82,82,82,82,82,82,82,82,82,82,82,82,82,82,82,86,79,79,87,82,82,82,82,82,82,82,82,82,82,82,82,82,82,82,82,82,82,82,82,82,82,82,82,83,2,4,4,-4,-4,-4,-4,-4,-4,-4,-4,-4,-4,-4,-4,-4,-4,-4,-4,-4,-4,-4,-4,-4,-4,-4,-4,-4,-4,-4,-4,-4,-4,-4,-4,-4,-4,-4,-4,2,2,23,24,25,2,5,5,-8,0,0,0,0,0,0,0,0,0
-44,-44,-44,-44,-44,-44,-44,-44,-44,-4,-4,-4,-4,-4,-104,4,4,4,4,4,4,4,4,4,4,4,4,4,4,4,4,4,4,4,4,4,4,4,4,4,78,79,79,80,3,3,3,3,3,4,2,2,4,2,2,2,2,3,4,3,2,4,2,4,2,4,2,4,4,3,3,3,-4,-4,-4,-4,-4,-4,-4,-4,-4,-4,-4,-4,-4,-4,-4,-4,-4,-4,-4,-4,-4,-4,-4,-4,-4,-4,-4,-4,-4,-4,-4,-4,-4,-4,-4,-4,5,2,23,24,25,2,5,5,-8,0,0,0,0,0,0,0,0,0
-44,-44,-44,-44,-44,-44,-44,-44,-44,-4,-4,-4,-4,-4,-104,-100,-100,-100,-100,-100,-100,-100,-100,-100,-100,-100,-100,-100,-100,-100,-100,-100,-100,-100,-100,-100,-100,-100,-103,3,78,79,79,80,2,-102,-100,-100,-100,-100,-100,-100,-100,2,4,3,3,3,2,4,2,4,2,3,2,4,2,4,2,4,2,4,-4,-4,-4,-4,-4,-4,-4,-4,-4,-4,-4,-4,-4,-4,-4,-4,-4,-4,-4,-4,-4,-4,-4,-4,-4,-4,-4,-4,-4,-4,-4,-4,-4,-4,-4,-4,2,2,23,24,25,2,5,5,-8,0,0,0,0,0,0,0,0,0
-44,-44,-44,-44,-44,-44,-44,-44,-44,-4,-4,-4,-4,-4,-4,-4,-4,-4,-4,-4,-4,-4,-4,-4,-4,-4,-4,-4,-4,-4,-4,-4,-4,-4,-4,-4,-4,-4,-104,4,78,79,79,80,4,-101,-4,-4,-4,-4,-4,-4,-4,-4,-4,-4,-4,-4,-4,-4,-4,-4,-4,-4,-4,-4,-4,-4,-4,-4,-4,-4,-4,-4,-4,-4,-4,-4,-4,-4,-4,-4,-4,-4,-4,-4,-4,-4,-4,-4,-4,-4,-4,-4,-4,-4,-4,-4,-4,-4,-4,-4,-4,-4,-4,-4,-4,-4,2,2,23,24,25,2,2,2,-8,0,0,0,0,0,0,0,0,0
-44,-44,-44,-44,-44,-44,-44,-44,-44,-4,-4,-4,-4,-4,-4,-4,-4,-4,-4,-4,-4,-4,-4,-4,-4,-4,-4,-4,-4,-4,-4,-4,-4,-4,-4,-4,-4,-4,-104,-2,-2,2,3,-2,-2,-101,-4,-4,-4,-4,-4,-4,-4,-4,-4,-4,-4,-4,-4,-4,-4,-4,-4,-4,-4,-4,-4,-4,-4,-4,-4,-4,-4,-4,-4,-4,-4,-4,-4,-4,-4,-4,-4,-4,-4,-4,-4,-4,-4,-4,-4,-4,-4,-4,-4,-4,-4,-4,-4,-4,-4,-4,-4,-4,-4,-4,-4,-4,2,2,2,2,2,2,2,2,-8,0,0,0,0,0,0,0,0,0
-44,-44,-44,-44,-44,-44,-44,-44,-44,-4,-4,-4,-4,-4,-4,-4,-4,-4,-4,-4,-4,-4,-4,-4,-4,-4,-4,-4,-4,-4,-4,-4,-4,-4,-4,-4,-4,-4,-104,-2,-2,-2,-2,-2,-2,-101,-4,-4,-4,-4,-4,-4,-4,-4,-4,-4,-4,-4,-4,-4,-4,-4,-4,-4,-4,-4,-4,-4,-4,-4,-4,-4,-4,-4,-4,-4,-4,-4,-4,-4,-4,-4,-4,-4,-4,-4,-4,-4,-4,-4,-4,-4,-4,-4,-4,-4,-4,-4,-4,-4,-4,-4,-4,-4,-4,-4,2,2,2,2,2,2,2,2,2,2,-8,0,0,0,0,0,0,0,0,0
-44,-44,-44,-44,-44,-44,-44,-44,-44,-4,-4,-4,-4,-4,-4,-4,-4,-4,-4,-4,-4,-4,-4,-4,-4,-4,-4,-4,-4,-4,-4,-4,-4,-4,-4,-4,-4,-4,-104,-2,-2,-2,-2,-2,-2,-101,-4,-4,-4,-4,-4,-4,-4,-4,-4,-4,-4,-4,-4,-4,-4,-4,-4,-4,-4,-4,-4,-4,-4,-4,-4,-4,-4,-4,-4,-4,-4,-4,-4,-4,-4,-4,-4,-4,-4,-4,-4,-4,-4,-4,-4,-4,-4,-4,-4,-4,-4,-4,-4,-4,-4,-4,-4,-4,-4,-4,2,2,2,2,2,2,2,2,2,2,-8,0,0,0,0,0,0,0,0,0
