10,11,,,,,,,,,
-14,-14,-14,-14,-14,-14,-14,-14,-14,-14,-14
-14,-14,-14,-14,-14,-14,-14,-14,-14,-14,-14
-14,-14,-14,-14,-14,-14,-14,-14,-14,-14,-14
-14,-14,-14,-14,14,14,14,14,14,14,14
-14,-14,-14,-14,14,14,14,14,14,14,14
-14,-14,-14,-14,14,14,14,-14,-14,14,-14
14,14,14,14,14,14,14,-14,-14,14,-14
14,-14,-14,14,14,14,14,-14,-14,14,-14
-14,14,14,14,14,14,14,14,14,14,-14
-14,-14,-14,-14,-14,14,-14,-14,-14,-14,-14
