6,,,,,,,,,,
-47,-47,-47,-47,-47,-47,-47,-47,-47,-47,-47
-47,-47,-47,-47,-47,-47,-47,-47,-47,-47,-47
-60,-61,-61,-61,-61,53,53,53,53,53,-60
-60,-61,53,53,53,53,53,53,53,-18,-61
-61,53,53,17,53,53,53,53,53,19,53
53,53,53,53,53,53,53,53,53,53,53
