60,,,,,,,,,,,,,,,,,,,,,,,,,,,,,,,,,,,,,,,,,,,,,,,,,,,,,,,,,,,,,,,,
-4,-4,-4,-4,-4,-4,-4,-4,-4,-4,-4,-4,-4,-4,-4,-4,-4,-4,-4,-4,-4,-4,-4,-4,-4,-4,-4,-4,-4,-101,-4,-4,-4,-4,-101,-4,-4,-4,-4,-4,-4,-4,-4,-4,-4,-4,-4,-4,-4,-4,-4,-4,-4,-4,-4,-4,-4,-4,-4,-4,-4,-4,-4,-4,-4
-4,-4,-4,-4,-4,-4,-4,-4,-4,-4,-4,-4,-4,-4,-4,-4,-4,-4,-4,-4,-4,-4,-4,-4,-4,-4,-4,-4,-4,-101,-4,-4,-4,-4,-101,-4,-4,-4,-4,-4,-4,-4,-4,-4,-4,-4,-4,-4,-4,-4,-4,-4,-4,-4,-4,-4,-4,-4,-4,-4,-4,-4,-4,-4,-4
-4,-4,-4,-4,-4,-4,-4,-4,-4,-4,-4,-4,-4,-4,-4,-4,-4,-4,-4,-4,-4,-4,-4,-4,-4,-4,-4,-4,-4,-101,-4,-4,-4,-4,-101,-4,-4,-4,-4,-4,-4,-4,-4,-4,-4,-4,-4,-4,-4,-4,-4,-4,-4,-4,-4,-4,-4,-4,-4,-4,-4,-4,-4,-4,-4
-4,-4,-4,-4,-4,-4,-4,-4,-4,-4,-4,-4,-4,-4,-4,-4,-4,-4,-4,-4,-4,-4,-4,-4,-4,-4,-4,-4,-4,-101,-4,-4,-4,-4,-101,-4,-4,-4,-4,-4,-4,-4,-4,-4,-4,-4,-4,-4,-4,-4,-4,-4,-4,-4,-4,-4,-4,-4,-4,-4,-4,-4,-4,-4,-4
-4,-4,-4,-4,-4,-4,-4,-4,-4,-4,-4,-4,-4,-4,-4,-4,-4,-4,-4,-4,-4,-4,-4,-4,-4,-4,-4,-4,-4,-101,-4,-4,-4,-4,-101,-4,-4,-4,-4,-4,-4,-4,-4,-4,-4,-4,-4,-4,-4,-4,-4,-4,-4,-4,-4,-4,-4,-4,-4,-4,-4,-4,-4,-4,-4
-4,-4,-4,-4,-4,-4,-4,-4,-4,-4,-4,-4,-4,-4,-4,-4,-4,-4,-4,-4,-4,-4,-4,-4,-4,-4,-4,-4,-4,-101,-4,-4,-4,-4,-101,-4,-4,-4,-4,-4,-4,-4,-4,-4,-4,-4,-4,-4,-4,-4,-4,-4,-4,-4,-4,-4,-4,-4,-4,-4,-4,-4,-4,-4,-4
-4,-4,-4,-4,-4,-4,-4,-4,-4,-4,-4,-4,-4,-4,-4,-4,-4,-4,-4,-4,-4,-4,-4,-4,-4,-4,-4,-4,-4,-101,-4,-4,-4,-4,-101,-4,-4,-4,-4,-4,-4,-4,-4,-4,-4,-4,-4,-4,-4,-4,-4,-4,-4,-4,-4,-4,-4,-4,-4,-4,-4,-4,-4,-4,-4
-4,-4,-4,-4,-4,-4,-4,-4,-4,-4,-4,-4,-4,-4,-4,-4,-4,-4,-4,-4,-4,-4,-4,-4,-4,-4,-4,-4,-4,-101,-4,-4,-4,-4,-101,-4,-4,-4,-4,-4,-4,-4,-4,-4,-4,-4,-4,-4,-4,-4,-4,-4,-4,-4,-4,-4,-4,-4,-4,-4,-4,-4,-4,-4,-4
-4,-4,-4,-4,-4,-4,-4,-4,-4,-4,-4,-4,-4,-4,-4,-4,-4,-4,-4,-4,-4,-4,-4,-4,-4,-4,-4,-4,-4,-101,-4,-4,-4,-4,-101,-4,-4,-4,-4,-4,-4,-4,-4,-4,-4,-4,-4,-4,-4,-4,-4,-4,-4,-4,-4,-4,-4,-4,-4,-4,-4,-4,-4,-4,-4
-4,-4,-4,-4,-4,-4,-4,-4,-4,-4,-4,-4,-4,-4,-4,-4,-4,-4,-4,-4,-4,-4,-4,-4,-4,-4,-4,-4,-4,-101,-4,-4,-4,-4,-101,-4,-4,-4,-4,-4,-4,-4,-4,-4,-4,-4,-4,-4,-4,-4,-4,-4,-4,-4,-4,-4,-4,-4,-4,-4,-4,-4,-4,-4,-4
-4,-4,-4,-4,-4,-4,-4,-4,-4,-4,-53,-54,-54,-54,-54,-54,-54,-54,-54,-54,-54,-54,-54,-54,-54,-54,-54,-54,-54,-54,54,54,54,54,-54,-54,-54,-54,-54,-54,-54,-54,-54,-54,-54,-54,-54,-54,-54,-54,-54,-54,-54,-54,-55,-4,-4,-4,-4,-4,-4,-4,-4,-4,-4
-4,-4,-4,-4,-4,-4,-4,-4,-4,-4,-56,-57,-57,-57,-57,-57,-57,-57,-57,-57,-57,-57,-57,-57,-57,57,57,57,57,57,57,57,57,57,57,57,57,57,57,57,57,57,-57,-57,-57,-57,-57,-57,-57,57,57,57,57,57,-58,-4,-4,-4,-4,-4,-4,-4,-4,-4,-4
-4,-4,-4,-4,-4,-4,-4,-4,-4,-4,-56,-57,-57,-57,-57,-57,-57,-57,-57,-57,-57,-57,-57,-57,-57,57,57,57,57,57,57,57,57,57,57,57,-57,-57,-57,-57,-57,-57,-57,-57,-57,-57,-57,-57,-57,-57,-57,-57,-57,57,-58,-4,-4,-4,-4,-4,-4,-4,-4,-4,-4
-4,-4,-4,-4,-4,-4,-4,-4,-4,-4,-56,-57,-57,-57,-57,-57,-57,-57,-57,-57,-57,-57,-57,-57,-57,57,57,57,57,57,57,57,57,57,57,57,-57,-57,-57,-57,-57,-57,-57,-57,-57,-57,-57,-57,-57,-57,-57,-57,-57,57,-58,-4,-4,-4,-4,-4,-4,-4,-4,-4,-4
-4,-4,-4,-4,-4,-4,-4,-4,-4,-4,-56,-57,-57,-57,-57,-57,-57,-57,-57,-57,-57,-57,-57,-57,-57,57,57,57,57,57,57,57,57,57,57,57,-57,-57,-57,-57,-57,-57,-57,-57,-57,-57,-57,-57,-57,-57,-57,-57,-57,57,-58,-4,-4,-4,-4,-4,-4,-4,-4,-4,-4
-4,-4,-4,-4,-4,-4,-4,-4,-4,-4,-56,-57,-57,-57,-57,-57,-57,-57,-57,-57,-57,-57,-57,-57,-57,-57,-57,-57,-57,57,57,57,57,57,57,57,57,57,-57,57,-57,57,57,57,-57,57,-57,57,57,57,57,57,57,57,-58,-4,-4,-4,-4,-4,-4,-4,-4,-4,-4
-4,-4,-4,-4,-4,-4,-4,-4,-4,-4,-56,-57,-57,-57,-57,-57,-57,-57,-57,-57,-57,-57,-57,-57,-57,-57,-57,-57,-57,57,57,57,57,57,57,57,57,57,57,57,57,57,57,57,57,57,57,57,57,57,57,57,57,57,-58,-4,-4,-4,-4,-4,-4,-4,-4,-4,-4
-4,-4,-4,-4,-4,-4,-4,-4,-4,-4,-56,-57,57,-57,-57,-57,-57,-57,-57,-57,-57,57,-57,-57,-57,-57,-57,-57,-57,57,57,57,57,57,57,57,57,57,57,57,57,57,57,57,57,57,57,57,57,57,57,57,57,57,-58,-4,-4,-4,-4,-4,-4,-4,-4,-4,-4
-4,-4,-4,-4,-4,-4,-4,-4,-4,-4,-56,57,57,57,57,-57,-57,-57,-57,-57,57,57,57,57,57,57,57,57,57,57,57,57,57,57,57,57,57,57,57,57,57,57,57,57,57,57,57,57,57,57,57,57,57,57,-58,-4,-4,-4,-4,-4,-4,-4,-4,-4,-4
-4,-4,-4,-4,-4,-4,-4,-4,-4,-4,-56,57,57,57,57,-57,-57,-57,-57,-57,57,57,57,57,57,57,57,57,57,57,57,57,57,57,57,57,57,57,57,57,57,57,57,57,57,57,57,57,57,57,57,57,57,57,-58,-4,-4,-4,-4,-4,-4,-4,-4,-4,-4
-4,-4,-4,-4,-4,-4,-4,-4,-4,-4,-56,57,57,57,57,-57,-57,-57,-57,-57,-57,-57,-57,-57,-57,-57,-57,-57,-57,-57,-57,-57,-57,-57,57,57,57,57,57,57,57,57,57,57,57,-57,-57,-57,-57,-57,57,57,57,57,-58,-4,-4,-4,-4,-4,-4,-4,-4,-4,-4
-4,-4,-4,-4,-4,-4,-4,-4,-4,-4,-56,57,57,57,57,-57,-57,-57,-57,-57,-57,-57,-57,-57,-57,-57,57,57,57,57,57,57,57,57,57,57,57,57,57,57,57,57,57,57,57,-57,-57,-57,-57,-57,57,57,57,57,-58,-4,-4,-4,-4,-4,-4,-4,-4,-4,-4
-4,-4,-4,-4,-4,-4,-4,-4,-4,-4,-56,57,57,57,57,-57,57,-57,-57,-57,-57,57,-57,-57,-57,-57,-57,-57,57,57,57,57,57,57,57,57,57,57,57,57,57,57,57,57,57,-57,-57,-57,-57,-57,57,57,57,57,-58,-4,-4,-4,-4,-4,-4,-4,-4,-4,-4
-4,-4,-4,-4,-4,-4,-4,-4,-4,-4,-56,57,57,57,57,57,57,57,57,57,-57,-57,-57,-57,-57,-57,-57,-57,-57,-57,-57,-57,-57,-57,-57,57,57,57,57,57,57,57,57,57,57,-57,-57,-57,-57,-57,57,57,57,57,-58,-4,-4,-4,-4,-4,-4,-4,-4,-4,-4
-4,-4,-4,-4,-4,-4,-4,-4,-4,-4,-56,57,57,57,57,57,57,57,57,57,-57,-57,-57,-57,-57,-57,-57,-57,-57,-57,-57,-57,-57,-57,-57,57,57,57,57,57,57,57,57,57,57,-57,-57,-57,-57,-57,-57,-57,-57,-57,-58,-4,-4,-4,-4,-4,-4,-4,-4,-4,-4
-4,-4,-4,-4,-4,-4,-4,-4,-4,-4,-56,57,57,57,57,57,57,57,57,57,-57,57,-57,-57,-57,-57,-57,-57,-57,-57,-57,-57,-57,-57,-57,-57,-57,-57,-57,57,-57,-57,-57,-57,-57,-57,-57,-57,-57,-57,-57,-57,-57,-57,-58,-4,-4,-4,-4,-4,-4,-4,-4,-4,-4
-4,-4,-4,-4,-4,-4,-4,-4,-4,-4,-56,57,57,57,57,-57,-57,-57,-57,-57,-57,-57,-57,-57,-57,-57,-57,-57,-57,-57,-57,-57,-57,-57,-57,-57,-57,-57,-57,57,-57,-57,-57,-57,-57,-57,-57,-57,-57,-57,-57,-57,-57,-57,-58,-4,-4,-4,-4,-4,-4,-4,-4,-4,-4
-100,-100,-100,-100,-100,-100,-100,-100,-100,-100,-56,57,57,57,57,-57,-57,-57,-57,-57,-57,-57,-57,-57,-57,-57,-57,-57,-57,-57,-57,-57,-57,-57,-57,-57,-57,-57,-57,57,-57,-57,-57,-57,-57,-57,57,-57,-57,-57,-57,57,-57,-57,-58,-100,-100,-100,-100,-100,-100,-100,-100,-100,-100
4,4,4,4,4,4,4,4,4,4,56,57,57,57,57,-57,-57,-57,-57,-57,-57,57,-57,-57,-57,-57,-57,-57,-57,-57,-57,-57,-57,-57,-57,57,57,57,57,57,-57,-57,-57,-57,-57,57,57,57,57,57,57,57,57,57,58,4,4,4,4,4,4,4,4,4,4
4,4,4,4,4,4,4,4,4,4,56,57,57,57,57,-57,-57,-57,-57,-57,57,57,57,57,57,-57,-57,-57,-57,-57,-57,-57,-57,-57,-57,57,57,57,57,57,-57,-57,-57,-57,-57,57,57,57,57,57,57,57,57,57,58,4,4,4,4,4,4,4,4,4,4
4,4,4,4,4,4,4,4,4,4,56,57,57,57,57,-57,-57,-57,-57,-57,57,57,57,57,57,-57,-57,-57,-57,-57,-57,-57,-57,-57,-57,-57,-57,-57,-57,-57,-57,-57,-57,-57,-57,-57,-57,-57,-57,-57,57,57,57,57,58,4,4,4,4,4,4,4,4,4,4
4,4,4,4,4,4,4,4,4,4,56,57,57,57,57,-57,-57,-57,-57,-57,-57,-57,-57,-57,-57,-57,-57,-57,-57,-57,-57,-57,-57,-57,-57,-57,-57,-57,-57,-57,-57,-57,-57,-57,-57,-57,-57,-57,-57,-57,57,57,57,57,58,4,4,4,4,4,4,4,4,4,4
-100,-100,-100,-100,-100,-100,-100,-100,-100,-100,-56,57,57,57,57,-57,57,-57,-57,-57,-57,-57,-57,-57,-57,-57,-57,-57,-57,-57,-57,-57,-57,-57,-57,-57,-57,-57,-57,-57,-57,-57,-57,-57,-57,-57,-57,-57,-57,-57,57,57,57,57,-58,-100,-100,-100,-100,-100,-100,-100,-100,-100,-100
-4,-4,-4,-4,-4,-4,-4,-4,-4,-4,-56,57,57,57,57,57,57,57,57,57,-57,-57,-57,-57,-57,-57,-57,-57,-57,-57,-57,-57,-57,-57,-57,-57,-57,-57,-57,-57,-57,-57,-57,-57,-57,-57,-57,-57,-57,-57,57,57,57,57,-58,-4,-4,-4,-4,-4,-4,-4,-4,-4,-4
-4,-4,-4,-4,-4,-4,-4,-4,-4,-4,-56,-57,-57,-57,-57,57,57,57,57,57,-57,-57,-57,-57,-57,-57,-57,-57,-57,-57,-57,-57,-57,-57,-57,-57,-57,-57,-57,-57,-57,-57,-57,-57,-57,-57,-57,-57,-57,-57,57,57,57,57,-58,-4,-4,-4,-4,-4,-4,-4,-4,-4,-4
-4,-4,-4,-4,-4,-4,-4,-4,-4,-4,-56,-57,-57,-57,-57,-57,-57,-57,-57,57,-57,-57,-57,-57,-57,-57,-57,-57,-57,-57,-57,-57,-57,-57,-57,-57,-57,-57,-57,-57,-57,-57,-57,-57,-57,-57,-57,-57,-57,-57,57,57,57,57,-58,-4,-4,-4,-4,-4,-4,-4,-4,-4,-4
-4,-4,-4,-4,-4,-4,-4,-4,-4,-4,-56,-57,-57,-57,-57,-57,-57,-57,-57,57,-57,-57,-57,-57,-57,-57,-57,-57,-57,-57,-57,-57,-57,-57,-57,-57,-57,-57,-57,-57,-57,-57,-57,-57,-57,-57,-57,-57,-57,-57,57,57,57,57,-58,-4,-4,-4,-4,-4,-4,-4,-4,-4,-4
-4,-4,-4,-4,-4,-4,-4,-4,-4,-4,-56,-57,57,-57,-57,-57,-57,-57,-57,57,-57,57,-57,-57,-57,-57,-57,-57,-57,-57,-57,-57,-57,-57,-57,-57,-57,-57,-57,-57,-57,-57,-57,-57,-57,-57,57,-57,-57,-57,57,57,57,57,-58,-4,-4,-4,-4,-4,-4,-4,-4,-4,-4
-4,-4,-4,-4,-4,-4,-4,-4,-4,-4,-56,57,57,57,57,57,57,57,57,57,57,57,57,57,57,57,57,57,57,57,57,57,57,57,57,57,57,57,57,57,57,57,57,57,57,57,57,57,57,57,57,57,57,57,-58,-4,-4,-4,-4,-4,-4,-4,-4,-4,-4
-4,-4,-4,-4,-4,-4,-4,-4,-4,-4,-56,57,57,57,57,57,57,57,57,57,57,57,57,57,57,57,57,57,57,57,57,57,57,57,57,57,57,57,57,57,57,57,57,57,57,57,57,57,57,57,57,57,57,57,-58,-4,-4,-4,-4,-4,-4,-4,-4,-4,-4
-4,-4,-4,-4,-4,-4,-4,-4,-4,-4,-56,57,57,57,57,57,57,57,57,57,57,57,57,57,57,57,57,57,57,57,57,57,57,57,57,57,57,57,57,57,57,57,57,57,57,57,57,57,57,57,57,57,57,57,-58,-4,-4,-4,-4,-4,-4,-4,-4,-4,-4
-4,-4,-4,-4,-4,-4,-4,-4,-4,-4,-56,57,57,57,57,-57,-57,-57,-57,-57,-57,-57,-57,-57,57,57,57,57,57,57,57,57,57,57,57,57,57,57,57,57,57,57,57,57,57,57,57,57,57,57,57,57,57,57,-58,-4,-4,-4,-4,-4,-4,-4,-4,-4,-4
-4,-4,-4,-4,-4,-4,-4,-4,-4,-4,-56,-57,-57,-57,-57,-57,-57,-57,-57,-57,-57,-57,-57,-57,57,57,57,57,57,57,57,57,57,57,57,57,57,57,57,57,57,57,57,57,57,57,57,57,57,57,57,57,57,57,-58,-4,-4,-4,-4,-4,-4,-4,-4,-4,-4
-4,-4,-4,-4,-4,-4,-4,-4,-4,-4,-56,-57,-57,-57,-57,-57,-57,-57,-57,-57,-57,-57,-57,-57,57,57,57,57,57,57,57,57,57,57,57,57,57,57,57,57,57,57,57,57,57,57,57,57,57,57,57,57,57,57,-58,-4,-4,-4,-4,-4,-4,-4,-4,-4,-4
-4,-4,-4,-4,-4,-4,-4,-4,-4,-4,-56,-57,57,-57,-57,-57,-57,57,-57,-57,-57,57,-57,-57,57,57,57,57,57,57,57,57,57,57,57,57,57,57,57,57,57,57,57,57,57,57,57,57,57,57,57,57,57,57,-58,-4,-4,-4,-4,-4,-4,-4,-4,-4,-4
-4,-4,-4,-4,-4,-4,-4,-4,-4,-4,-56,57,57,57,57,57,57,57,57,57,57,57,57,57,57,57,57,57,57,57,57,57,57,57,57,57,57,57,57,57,57,57,57,57,57,57,57,57,57,57,57,57,57,57,-58,-4,-4,-4,-4,-4,-4,-4,-4,-4,-4
-4,-4,-4,-4,-4,-4,-4,-4,-4,-4,-56,57,57,57,57,57,57,57,57,57,57,57,57,57,57,57,57,57,57,57,57,57,57,57,57,57,57,57,57,57,57,57,57,57,57,57,57,57,57,57,57,57,57,57,-58,-4,-4,-4,-4,-4,-4,-4,-4,-4,-4
-4,-4,-4,-4,-4,-4,-4,-4,-4,-4,-56,57,57,57,57,57,57,57,57,57,57,57,57,57,57,57,57,57,57,57,57,57,57,57,57,57,57,57,57,57,57,57,57,57,57,57,57,57,57,57,57,57,57,57,-58,-4,-4,-4,-4,-4,-4,-4,-4,-4,-4
-4,-4,-4,-4,-4,-4,-4,-4,-4,-4,-56,-57,-57,-57,-57,-57,-57,-57,-57,-57,-57,-57,-57,-57,-57,-57,-57,-57,-57,-57,57,57,57,57,-57,-57,-57,-57,-57,-57,-57,-57,-57,-57,-57,-57,-57,-57,-57,-57,-57,-57,-57,-57,-58,-4,-4,-4,-4,-4,-4,-4,-4,-4,-4
-4,-4,-4,-4,-4,-4,-4,-4,-4,-4,59,60,60,60,60,60,60,60,60,60,60,60,60,60,60,60,60,60,60,-60,60,60,60,60,-60,60,60,60,60,60,60,60,60,60,60,60,60,60,60,60,60,60,60,60,61,-4,-4,-4,-4,-4,-4,-4,-4,-4,-4
-4,-4,-4,-4,-4,-4,-4,-4,-4,-4,-4,-4,-4,-4,-4,-4,-4,-4,-4,-4,-4,-4,-4,-4,-4,-4,-4,-4,-4,-101,-4,-4,-4,-4,-101,-4,-4,-4,-4,-4,-4,-4,-4,-4,-4,-4,-4,-4,-4,-4,-4,-4,-4,-4,-4,-4,-4,-4,-4,-4,-4,-4,-4,-4,-4
-4,-4,-4,-4,-4,-4,-4,-4,-4,-4,-4,-4,-4,-4,-4,-4,-4,-4,-4,-4,-4,-4,-4,-4,-4,-4,-4,-4,-4,-101,-4,-4,-4,-4,-101,-4,-4,-4,-4,-4,-4,-4,-4,-4,-4,-4,-4,-4,-4,-4,-4,-4,-4,-4,-4,-4,-4,-4,-4,-4,-4,-4,-4,-4,-4
-4,-4,-4,-4,-4,-4,-4,-4,-4,-4,-4,-4,-4,-4,-4,-4,-4,-4,-4,-4,-4,-4,-4,-4,-4,-4,-4,-4,-4,-101,-4,-4,-4,-4,-101,-4,-4,-4,-4,-4,-4,-4,-4,-4,-4,-4,-4,-4,-4,-4,-4,-4,-4,-4,-4,-4,-4,-4,-4,-4,-4,-4,-4,-4,-4
-4,-4,-4,-4,-4,-4,-4,-4,-4,-4,-4,-4,-4,-4,-4,-4,-4,-4,-4,-4,-4,-4,-4,-4,-4,-4,-4,-4,-4,-101,-4,-4,-4,-4,-101,-4,-4,-4,-4,-4,-4,-4,-4,-4,-4,-4,-4,-4,-4,-4,-4,-4,-4,-4,-4,-4,-4,-4,-4,-4,-4,-4,-4,-4,-4
-4,-4,-4,-4,-4,-4,-4,-4,-4,-4,-4,-4,-4,-4,-4,-4,-4,-4,-4,-4,-4,-4,-4,-4,-4,-4,-4,-4,-4,-101,-4,-4,-4,-4,-101,-4,-4,-4,-4,-4,-4,-4,-4,-4,-4,-4,-4,-4,-4,-4,-4,-4,-4,-4,-4,-4,-4,-4,-4,-4,-4,-4,-4,-4,-4
-4,-4,-4,-4,-4,-4,-4,-4,-4,-4,-4,-4,-4,-4,-4,-4,-4,-4,-4,-4,-4,-4,-4,-4,-4,-4,-4,-4,-4,-101,-4,-4,-4,-4,-101,-4,-4,-4,-4,-4,-4,-4,-4,-4,-4,-4,-4,-4,-4,-4,-4,-4,-4,-4,-4,-4,-4,-4,-4,-4,-4,-4,-4,-4,-4
-4,-4,-4,-4,-4,-4,-4,-4,-4,-4,-4,-4,-4,-4,-4,-4,-4,-4,-4,-4,-4,-4,-4,-4,-4,-4,-4,-4,-4,-101,-4,-4,-4,-4,-101,-4,-4,-4,-4,-4,-4,-4,-4,-4,-4,-4,-4,-4,-4,-4,-4,-4,-4,-4,-4,-4,-4,-4,-4,-4,-4,-4,-4,-4,-4
-4,-4,-4,-4,-4,-4,-4,-4,-4,-4,-4,-4,-4,-4,-4,-4,-4,-4,-4,-4,-4,-4,-4,-4,-4,-4,-4,-4,-4,-101,-4,-4,-4,-4,-101,-4,-4,-4,-4,-4,-4,-4,-4,-4,-4,-4,-4,-4,-4,-4,-4,-4,-4,-4,-4,-4,-4,-4,-4,-4,-4,-4,-4,-4,-4
-4,-4,-4,-4,-4,-4,-4,-4,-4,-4,-4,-4,-4,-4,-4,-4,-4,-4,-4,-4,-4,-4,-4,-4,-4,-4,-4,-4,-4,-101,-4,-4,-4,-4,-101,-4,-4,-4,-4,-4,-4,-4,-4,-4,-4,-4,-4,-4,-4,-4,-4,-4,-4,-4,-4,-4,-4,-4,-4,-4,-4,-4,-4,-4,-4
-4,-4,-4,-4,-4,-4,-4,-4,-4,-4,-4,-4,-4,-4,-4,-4,-4,-4,-4,-4,-4,-4,-4,-4,-4,-4,-4,-4,-4,-101,-4,-4,-4,-4,-101,-4,-4,-4,-4,-4,-4,-4,-4,-4,-4,-4,-4,-4,-4,-4,-4,-4,-4,-4,-4,-4,-4,-4,-4,-4,-4,-4,-4,-4,-4
