15,,,,,,,,,,
-10,-10,-10,-10,-10,-10,-10,-10,-10,-10,-10
-10,-10,-10,-10,-10,-10,-10,-10,-10,-10,-10
10,10,10,-10,10,-10,10,-10,10,10,10
10,10,10,-10,10,10,10,-10,10,10,10
10,10,10,-10,10,10,10,-10,10,10,10
10,10,10,-10,10,10,10,-10,10,10,10
10,10,10,10,10,10,10,10,10,10,10
10,10,10,10,10,10,10,10,10,10,10
10,10,10,10,10,10,10,10,10,10,10
10,10,10,10,10,10,10,10,10,10,10
10,10,10,10,10,10,10,10,10,10,10
10,10,10,10,10,10,10,10,10,10,10
10,10,-10,10,10,10,10,10,-10,10,10
10,10,10,10,10,10,10,10,10,10,10
-14,-14,-14,-14,-14,14,-14,-14,-14,-14,-14
