12,11,,,,,,,,,
-18,-18,-18,-18,-18,-18,-18,-18,-18,-18,-18
-17,-17,-17,-17,-17,-17,-17,-17,-17,-17,-17
16,16,16,16,16,16,16,16,-16,16,16
16,-15,-15,15,15,15,15,15,15,15,15
16,15,-15,-15,15,15,15,15,-15,-15,-15
16,-15,-15,15,15,15,15,15,15,15,15
16,15,-15,-15,15,15,15,15,15,15,15
16,-15,-15,15,15,15,15,15,15,15,-15
16,15,-15,-15,15,15,15,15,15,15,15
16,-15,-15,15,15,15,15,15,15,-15,15
16,15,15,15,15,15,15,15,-15,15,-15
-14,-14,-14,-14,-14,14,-14,-14,-14,-14,-14
