20,,,,,,,,,,,,,,,,,,
-14,-14,-14,-14,-14,-14,-14,-14,-14,-14,-14,-14,-14,-14,-14,-14,-14,-14,-14
-14,-14,-14,-14,-14,-14,-14,-14,-14,-14,-14,-14,-14,-14,-14,-14,-14,-14,-14
-14,-14,-14,-14,-14,-14,-14,11,11,11,11,11,-14,-14,-14,-14,-14,-14,-14
-14,-14,-14,-14,-14,11,11,11,11,11,11,11,11,11,-14,-14,-14,-14,-14
-14,-14,-14,11,11,11,11,11,11,11,11,11,11,11,11,11,-14,-14,-14
-14,-14,11,11,11,11,11,11,11,11,11,11,11,11,11,11,11,-14,-14
-14,11,11,11,11,11,11,11,11,11,11,11,11,11,11,11,11,11,-14
-14,11,11,11,11,11,11,11,11,11,11,11,11,11,11,11,11,-11,-14
11,11,11,11,11,11,11,11,11,11,11,11,11,11,11,11,11,11,11
11,11,11,11,11,11,11,11,11,11,11,11,11,11,11,11,11,-11,-11
11,11,11,11,11,11,11,11,11,11,11,11,11,11,11,11,11,11,11
11,11,11,11,11,11,11,11,11,11,11,11,11,11,11,11,11,11,11
11,11,11,11,11,11,11,11,11,11,11,11,11,-11,-11,-11,-11,-11,-11
-14,11,11,11,11,11,11,11,11,11,11,11,11,-11,11,11,11,11,-14
-14,11,11,11,11,11,11,11,11,11,11,11,11,-11,11,11,11,11,-14
-14,-14,11,11,11,11,11,11,11,11,11,11,11,-11,11,11,11,-14,-14
-14,-14,-14,-14,11,11,11,11,11,11,11,11,11,-11,11,-14,-14,-14,-14
-14,-14,-14,-14,-14,-14,-14,11,11,11,11,11,-14,-14,-14,-14,-14,-14,-14
-14,-14,-14,-14,-14,-14,-14,-14,11,11,11,-14,-14,-14,-14,-14,-14,-14,-14
-14,-14,-14,-14,-14,-14,-14,-14,-14,14,-14,-14,-14,-14,-14,-14,-14,-14,-14
