14,13,,,,,,,,,,,
-4,-4,-4,-4,-4,-4,-4,-4,-4,-4,-4,-4,-4
-4,-4,-4,-4,-4,-4,-4,-4,-4,-4,-4,-4,-4
3,3,2,2,4,20,21,22,4,3,4,4,2
4,4,2,3,2,26,27,28,4,4,2,3,2
2,90,2,2,2,3,2,4,4,3,2,90,2
3,3,90,4,2,3,2,2,3,2,90,4,2
4,3,2,4,3,3,3,2,3,4,4,4,2
3,90,3,4,3,3,3,3,3,2,2,90,4
2,3,3,3,2,3,2,3,3,2,4,3,3
3,2,90,3,4,3,4,2,2,2,90,2,2
2,90,3,3,4,20,21,22,2,2,4,90,3
2,4,4,-4,2,23,24,25,4,-4,3,3,2
20,21,21,21,21,29,24,30,21,21,21,21,22
-14,-14,-14,-14,-14,-14,14,-14,-14,-14,-14,-14,-14
