11,11,,,,,,,,,
-35,-35,-35,-35,-35,-35,-35,-35,-35,-35,-35
35,35,-35,-35,-35,-35,-35,-35,-35,35,35
35,35,-35,-35,-35,35,-35,-35,-35,35,35
35,35,-35,-35,-35,-35,-35,-35,-35,35,35
35,35,35,35,35,35,35,35,35,35,35
35,35,35,35,35,35,35,35,35,35,35
35,35,35,35,35,35,35,35,35,35,35
35,35,35,35,35,35,35,35,35,35,35
35,35,35,35,35,35,35,35,35,35,35
35,35,35,35,35,35,35,35,35,35,35
-14,-14,-14,-14,-14,14,-14,-14,-14,-14,-14
